Iteration, Rt, delta p, delta n, nNT, nNe, nPT, nT, nI, nonmut, mut , GF , NF 
0,2.3251407699364424,0.1930599485139443,0.7371379852350599,0,0,25,25,0,7,18,1,0
1,2.838114614462194,0.22050205358872,0.8419169318842038,10,0,25,35,0,8,17,0.7142857142857143,0
2,3.4350408985563847,0.2504266977146929,0.9561746640015549,10,9,26,45,0,8,18,0.5777777777777777,0.2
3,4.207463869450907,0.2866858658899301,1.0946187606706421,16,13,30,59,0,12,18,0.5084745762711864,0.22033898305084745
4,4.704060956705088,0.30882182067326375,1.1791378607524616,15,21,36,72,0,18,18,0.5,0.2916666666666667
5,5.14834431453631,0.3279727348814668,1.2522595331837822,11,33,43,87,0,23,20,0.4942528735632184,0.3793103448275862
6,5.460293612337527,0.34109080816471227,1.3023467220834468,17,35,54,106,0,29,25,0.5094339622641509,0.330188679245283
7,6.154107510431465,0.36940497309243375,1.410455351807474,30,41,59,130,0,35,24,0.45384615384615384,0.3153846153846154
8,6.88074485413558,0.39793883224137966,1.5194028140125404,32,55,67,154,0,41,26,0.43506493506493504,0.35714285714285715
9,7.488301890039737,0.42103181562183417,1.6075760232833667,47,64,68,179,0,48,20,0.37988826815642457,0.3575418994413408
10,8.012820675248049,0.44046996595491167,1.6817944154642077,35,90,82,207,0,61,21,0.3961352657004831,0.43478260869565216
11,8.626127883302754,0.4626685153435925,1.7665525131300803,49,100,91,240,0,68,23,0.37916666666666665,0.4166666666666667
12,9.504619572939466,0.49357048065847897,1.8845418352414647,64,117,93,274,0,74,19,0.33941605839416056,0.42700729927007297
13,10.123154450073004,0.5147581844764747,1.965440340728358,65,147,94,306,0,77,17,0.30718954248366015,0.4803921568627451
14,10.780881645797749,0.536820226168886,2.0496772271902928,73,167,105,345,0,87,18,0.30434782608695654,0.48405797101449277
15,11.501984780494304,0.5604986155688899,2.1400856230812155,83,189,116,388,0,99,17,0.29896907216494845,0.48711340206185566
16,12.157200292368852,0.5815875035952291,2.220606831909056,93,212,125,430,0,111,14,0.29069767441860467,0.4930232558139535
17,12.754284379747334,0.6004775142388153,2.292732327093659,98,243,138,479,0,123,15,0.2881002087682672,0.5073068893528184
18,13.28421479532107,0.6169973204531614,2.355807950821162,111,263,160,534,0,146,14,0.299625468164794,0.49250936329588013
19,13.976841524263195,0.6382615939684607,2.4369988133341236,119,293,183,595,0,169,14,0.30756302521008405,0.492436974789916
20,14.62154243988533,0.6577408440122051,2.511374131682966,137,322,202,661,0,187,15,0.30559757942511345,0.48714069591527986
21,15.456067136083632,0.6825356634911344,2.606045260602513,147,365,214,726,0,204,10,0.29476584022038566,0.5027548209366391
22,16.137573978965268,0.7024544735406022,2.6820988989732086,153,417,228,798,0,220,8,0.2857142857142857,0.5225563909774437
23,16.65554642573976,0.7174064473788877,2.7391882536284813,176,449,259,884,0,249,10,0.29298642533936653,0.5079185520361991
24,17.308936523013664,0.7360482344821646,2.810365986204628,186,489,296,971,0,284,12,0.30484037075180226,0.5036045314109165
25,18.332468073816838,0.7647860836013736,2.920092319205246,227,526,305,1058,0,297,8,0.2882797731568998,0.497164461247637
26,19.116918580257263,0.7864502934368477,3.0028102113043293,238,603,305,1146,0,300,5,0.2661431064572426,0.5261780104712042
27,19.98417131471072,0.8100592418559652,3.0929534689045943,239,674,324,1237,0,317,7,0.26192400970088925,0.5448666127728375
28,20.393131288758106,0.8210733607943114,3.1350073775782787,266,733,333,1332,0,324,9,0.25,0.5503003003003003
29,21.121922519952477,0.8405205098609794,3.2092601285601052,277,777,387,1441,0,385,2,0.2685634975711312,0.5392088827203331
30,22.167105552690984,0.8680245559894013,3.3142755774140795,314,838,399,1551,0,397,2,0.2572533849129594,0.5402965828497743
31,23.107045450572844,0.8923919230649778,3.4073146153390055,340,926,399,1665,0,395,4,0.23963963963963963,0.5561561561561561
32,23.756054716404968,0.9090244468778469,3.4708206153517787,346,1028,414,1788,0,410,4,0.23154362416107382,0.5749440715883669
33,24.397943418128566,0.9253261415813833,3.533063449674373,353,1101,458,1912,0,454,4,0.2395397489539749,0.575836820083682
34,25.158932827222255,0.9444685384461694,3.6061526013399186,391,1161,494,2046,0,490,4,0.24144672531769307,0.5674486803519062
35,25.957266963855094,0.9643440257780057,3.6820408256978383,419,1244,528,2191,0,522,6,0.2409858512094934,0.56777727065267
36,27.017659550809693,0.9904316308653304,3.781648045122172,404,1347,587,2338,0,577,10,0.2510692899914457,0.5761334473909324
37,27.753659470741816,1.0083381264981561,3.850018301174778,446,1471,571,2488,0,559,12,0.2295016077170418,0.5912379421221865
38,28.412965881417893,1.024244714986502,3.9107525481302803,460,1565,632,2657,0,616,16,0.23786225065863756,0.5890101618366579
39,29.580108735024936,1.0521052697769315,4.017129211875557,516,1648,650,2814,0,642,8,0.23098791755508175,0.5856432125088842
40,30.51899514814647,1.0742520025525044,4.10168946429138,548,1800,638,2986,0,632,6,0.21366376423308775,0.6028131279303416
41,31.436340131766332,1.0956722720801362,4.183475947942336,568,1938,645,3151,0,637,8,0.2046969216121866,0.6150428435417328
42,32.34696484634982,1.1167304961436249,4.2638800761847495,589,2059,677,3325,0,669,8,0.203609022556391,0.6192481203007518
43,33.17518391045101,1.1357120783783219,4.336355208353594,614,2195,692,3501,0,684,8,0.19765781205369895,0.6269637246501
44,34.08357716487115,1.156350425181736,4.415156168875718,662,2313,704,3679,0,696,8,0.19135634683337863,0.6287034520250068
45,34.88720554501861,1.1744561537882285,4.484287132645963,671,2458,713,3842,0,707,6,0.1855804268610099,0.6397709526288391
46,35.46337792769389,1.1873518101677125,4.533525093367632,690,2599,701,3990,0,695,6,0.17568922305764412,0.6513784461152882
47,36.14210624619348,1.2024535919136605,4.591186441852162,745,2687,673,4105,0,671,2,0.16394640682095007,0.6545676004872107
48,36.46574724177527,1.2096213123755026,4.618554101797373,765,2791,634,4190,0,632,2,0.1513126491646778,0.666109785202864
49,36.59430844326821,1.2124626844895035,4.629402977141741,778,2864,613,4255,0,611,2,0.14406580493537016,0.673090481786134
50,36.70352290149393,1.214873854999554,4.638609264543749,819,2878,608,4305,0,606,2,0.14123112659698026,0.6685249709639953
51,36.71655690118382,1.215161451886822,4.639707361749682,850,2898,602,4350,0,600,2,0.13839080459770114,0.6662068965517242
52,36.75679613505838,1.216049121155005,4.643096644410019,875,2905,613,4393,0,611,2,0.13954017755520146,0.661279307989984
53,36.859862063124616,1.218321258464192,4.651772077772372,891,2930,613,4434,0,611,2,0.13824988723500226,0.6608028867839423
54,37.01920123328173,1.221829803039389,4.665168338877669,923,2937,614,4474,0,612,2,0.13723737147966025,0.656459544032186
55,37.29955669178786,1.2279908532911874,4.688692348929993,924,2990,590,4504,0,590,0,0.13099467140319715,0.6638543516873889
56,37.380804135667006,1.2297734469888368,4.695498615775558,949,3049,532,4530,0,532,0,0.11743929359823399,0.6730684326710816
57,37.51424554584395,1.2326983924901331,4.706666589507781,954,3081,516,4551,0,516,0,0.1133816743572841,0.6769940672379697
58,37.572414478644475,1.2339723304477175,4.71153071625492,997,3082,481,4560,0,481,0,0.10548245614035087,0.6758771929824562
59,37.61319317034522,1.2348650186961945,4.714939162294561,978,3106,487,4571,0,487,0,0.1065412382410851,0.6795012032378035
60,37.65752100552823,1.2358350355482497,4.718642863002408,998,3106,475,4579,0,475,0,0.1037344398340249,0.6783140423673291
61,37.67923810372068,1.236310127395494,4.720456850055522,1026,3106,450,4582,0,450,0,0.09821038847664776,0.6778699257965953
62,37.68397229314942,1.2364136822809326,4.720852241436289,1026,3106,452,4584,0,452,0,0.09860383944153578,0.6775741710296684
63,37.6839722931494,1.2364136822809326,4.720852241436289,1026,3106,452,4584,0,452,0,0.09860383944153578,0.6775741710296684
64,37.68397229314938,1.2364136822809326,4.720852241436287,1026,3106,452,4584,0,452,0,0.09860383944153578,0.6775741710296684
65,37.68397229314942,1.2364136822809326,4.720852241436289,1026,3106,452,4584,0,452,0,0.09860383944153578,0.6775741710296684
66,37.68397229314943,1.2364136822809324,4.720852241436288,1026,3106,452,4584,0,452,0,0.09860383944153578,0.6775741710296684
67,37.68397229314938,1.2364136822809326,4.720852241436287,1026,3106,452,4584,0,452,0,0.09860383944153578,0.6775741710296684
68,37.684711891182495,1.2364298597357088,4.720914009899978,1035,3106,443,4584,0,443,0,0.09664048865619546,0.6775741710296684
69,37.68446419120556,1.2364244417298755,4.720893322968614,1047,3106,431,4584,0,423,8,0.09402268760907505,0.6775741710296684
70,37.677414596459876,1.2362702391388711,4.720304549439324,1083,3106,395,4584,0,379,16,0.08616928446771378,0.6775741710296684
71,37.699662310686705,1.236756852161888,4.722162526436299,1118,3106,360,4584,0,314,46,0.07853403141361257,0.6775741710296684
72,37.669664252408104,1.2361006972826034,4.719657207806302,1149,3106,329,4584,0,256,73,0.07177137870855148,0.6775741710296684
73,37.67774588097435,1.2362774858601946,4.720332218738924,1182,3106,296,4584,0,198,98,0.06457242582897033,0.6775741710296684
74,37.67289342224701,1.2361713380690704,4.7199269271728115,1190,3106,288,4584,0,163,125,0.06282722513089005,0.6775741710296684
75,37.683572182797626,1.2364049305002918,4.720818825546565,1202,3106,276,4584,0,139,137,0.060209424083769635,0.6775741710296684
76,37.67789018993117,1.2362806425564767,4.720344271579274,1199,3106,279,4584,0,139,140,0.06086387434554974,0.6775741710296684
77,37.68894428304015,1.2365224341062084,4.721267475678251,1217,3106,261,4584,0,116,145,0.05693717277486911,0.6775741710296684
78,37.67994248417983,1.2363255351731055,4.720515679751858,1205,3106,273,4584,0,116,157,0.05955497382198953,0.6775741710296684
0,2.325140769936443,0.19305994851394429,0.7371379852350599,0,0,25,25,0,5,20,1,0
1,2.5313387503076967,0.2043115240791563,0.7800985464840513,12,0,15,27,0,3,12,0.5555555555555556,0
2,2.9965493114086983,0.22863373146797247,0.8729651565140767,10,9,12,31,0,3,9,0.3870967741935484,0.2903225806451613
3,3.361104158513703,0.24682018071314366,0.9424043263592757,12,9,15,36,0,4,11,0.4166666666666667,0.25
4,3.603944821935199,0.25856998320976265,0.9872672086190938,11,13,20,44,0,6,14,0.45454545454545453,0.29545454545454547
5,4.11558179662058,0.28249678541294,1.078624089758498,8,21,26,55,0,8,18,0.4727272727272727,0.38181818181818183
6,4.556928153583211,0.3023482593965428,1.1544206267867998,14,21,32,67,0,10,22,0.47761194029850745,0.31343283582089554
7,5.215320011129858,0.3308110387874148,1.2630966935519474,19,27,35,81,0,14,21,0.43209876543209874,0.3333333333333333
8,5.8508019020959665,0.3571655924183932,1.3637231710520468,18,39,34,91,0,16,18,0.37362637362637363,0.42857142857142855
9,6.081148014404029,0.36647954083349427,1.3992855195460685,14,49,46,109,0,21,25,0.42201834862385323,0.44954128440366975
10,6.507196253881876,0.3834028073299454,1.4639016279870642,21,52,54,127,0,29,25,0.4251968503937008,0.4094488188976378
11,7.127282348907026,0.40738840217446404,1.5554829901206806,31,58,57,146,0,33,24,0.3904109589041096,0.3972602739726027
12,7.844093461938748,0.43426469652987726,1.6581015685686227,37,71,61,169,0,39,22,0.3609467455621302,0.42011834319526625
13,8.426614232964116,0.4555066903954339,1.7392073633280203,43,83,66,192,0,41,25,0.34375,0.4322916666666667
14,9.330616952600941,0.4875280325062334,1.8614706695692547,49,98,66,213,0,49,17,0.30985915492957744,0.460093896713615
15,10.065877154011211,0.5128146644116279,1.958019627753488,51,117,73,241,0,53,20,0.3029045643153527,0.4854771784232365
16,10.845203005164796,0.5389533085273432,2.057821723468038,55,140,71,266,0,58,13,0.2669172932330827,0.5263157894736842
17,11.555714584145267,0.5622427830913185,2.1467451718032162,52,164,81,297,0,70,11,0.2727272727272727,0.5521885521885522
18,12.207441203724306,0.5831887164267369,2.226720553629359,60,176,94,330,0,82,12,0.28484848484848485,0.5333333333333333
19,12.981109941553944,0.6075759443373884,2.3198354238336645,66,195,99,360,0,90,9,0.275,0.5416666666666666
20,13.386356594608273,0.6201559931545706,2.36786833749927,63,225,110,398,0,97,13,0.27638190954773867,0.5653266331658291
21,13.86559918963681,0.6348704497088071,2.4240508079790817,70,234,136,440,0,119,17,0.3090909090909091,0.5318181818181819
22,14.674413825396188,0.6593254805347133,2.5174245620416325,91,247,147,485,0,135,12,0.3030927835051546,0.5092783505154639
23,15.238352280934164,0.6761110358035588,2.5815148639772234,94,279,161,534,0,152,9,0.301498127340824,0.5224719101123596
24,16.121918781721458,0.7020000953638552,2.6803640004801736,119,291,177,587,0,167,10,0.30153321976149916,0.4957410562180579
25,16.869061687289477,0.7235246015386437,2.762548478602093,114,339,185,638,0,177,8,0.28996865203761757,0.5313479623824452
26,17.86934919560151,0.7518511049293581,2.8707042188211864,125,370,199,694,0,190,9,0.28674351585014407,0.5331412103746398
27,18.25272612439232,0.7625667122733037,2.911618355952615,133,418,204,755,0,192,12,0.27019867549668874,0.5536423841059602
28,19.18837418435887,0.7884088144544315,3.0102882006441924,144,440,232,816,0,227,5,0.28431372549019607,0.5392156862745098
29,19.4930809635797,0.7967333741082526,3.042072882958783,151,489,244,884,0,240,4,0.27601809954751133,0.5531674208144797
30,20.386305826264067,0.8208901449192557,3.134307826055338,163,508,278,949,0,274,4,0.2929399367755532,0.5353003161222339
31,20.821410127603375,0.8325291414909028,3.178747631147081,174,556,296,1026,0,292,4,0.2884990253411306,0.5419103313840156
32,21.313479530808582,0.8455947072550936,3.2286343367921755,187,582,337,1106,0,333,4,0.3047016274864376,0.5262206148282098
33,22.12903550073513,0.8670304341376293,3.3104798394345845,197,624,368,1189,0,364,4,0.30950378469301937,0.5248107653490328
34,22.674811361446377,0.8812283768782974,3.3646901662625908,224,672,379,1275,0,377,2,0.2972549019607843,0.5270588235294118
35,23.268619201607834,0.896547065417395,3.4231797043209617,223,718,432,1373,0,430,2,0.314639475600874,0.5229424617625638
36,24.460157821075757,0.9268985193185599,3.5390670737617724,258,756,450,1464,0,448,2,0.3073770491803279,0.5163934426229508
37,25.094274418461456,0.9428496563170733,3.599971415028827,272,844,446,1562,0,444,2,0.2855313700384123,0.5403329065300896
38,26.337263036673445,0.9737327549215952,3.717888700609728,280,902,481,1663,0,481,0,0.28923631990378834,0.5423932651834035
39,26.982627736483952,0.9895752991181579,3.778378414814788,298,1005,467,1770,0,467,0,0.26384180790960454,0.5677966101694916
40,27.67365303458133,1.0063993467408914,3.84261568755613,300,1070,513,1883,0,513,0,0.272437599575146,0.5682421667551779
41,28.306101235362604,1.021674895818597,3.900940511307369,342,1121,533,1996,0,533,0,0.26703406813627256,0.561623246492986
42,29.331694349055855,1.0462065925237696,3.9946069896362104,357,1194,569,2120,0,569,0,0.26839622641509436,0.5632075471698114
43,30.04585136606317,1.0631201788893716,4.059186137577603,386,1292,572,2250,0,572,0,0.25422222222222224,0.5742222222222222
44,30.569984055797367,1.0754481908034317,4.106256728522193,395,1364,625,2384,0,625,0,0.26216442953020136,0.5721476510067114
45,31.124438872400507,1.0884129627407941,4.155758585010306,412,1437,674,2523,0,674,0,0.2671422909235038,0.5695600475624257
46,31.78374354357112,1.1037296695271055,4.214240556376219,440,1497,735,2672,0,735,0,0.2750748502994012,0.5602544910179641
47,32.12865830087903,1.1117003565825136,4.244674088769598,455,1592,770,2817,0,770,0,0.273340433084842,0.5651402200922968
48,32.82243189317108,1.1276470524583968,4.305561473022972,481,1644,823,2948,0,823,0,0.2791723202170963,0.5576662143826323
49,33.22690506014055,1.1368921789846778,4.340861047032407,484,1757,820,3061,0,820,0,0.26788631166285526,0.5739954263312643
50,33.40391414070893,1.1409262989936726,4.356264050703112,515,1827,821,3163,0,821,0,0.25956370534302875,0.5776161871640847
51,33.78681155884732,1.1496284202410223,4.389490331829356,538,1880,836,3254,0,836,0,0.2569145666871543,0.5777504609711125
52,33.90173989028471,1.1522339750441912,4.399438813805093,543,1958,834,3335,0,834,0,0.2500749625187406,0.5871064467766117
53,34.1127336537591,1.157009790895289,4.4176737470547405,560,2005,845,3410,0,845,0,0.24780058651026393,0.5879765395894428
0,2.325140769936443,0.19305994851394429,0.73713798523506,0,0,25,25,0,4,21,1,0
1,2.579665295780262,0.20690370102740044,0.7899959493773472,11,0,19,30,0,6,13,0.6333333333333333,0
2,3.0875392538868396,0.2332389138567898,0.8905485801804701,10,9,17,36,0,7,10,0.4722222222222222,0.25
3,3.640092997235653,0.2602961060628152,0.9938578595125671,15,9,20,44,0,10,10,0.45454545454545453,0.20454545454545456
4,4.108343201572574,0.28216544631620316,1.077358976843685,9,21,24,54,0,16,8,0.4444444444444444,0.3888888888888889
5,4.71023018714361,0.309091768533583,1.1801685707645897,16,21,26,63,0,20,6,0.4126984126984127,0.3333333333333333
6,5.326325200817515,0.33548862869046553,1.2809565822726867,11,34,31,76,0,27,4,0.40789473684210525,0.4473684210526316
7,5.939568967986014,0.3607690766366129,1.3774819289761582,13,39,40,92,0,36,4,0.43478260869565216,0.42391304347826086
8,6.34585796286773,0.3770389783548507,1.4396033719003387,16,46,48,110,0,42,6,0.43636363636363634,0.41818181818181815
9,6.85605204896852,0.3969862112819646,1.5157655339856833,17,53,62,132,0,54,8,0.4696969696969697,0.4015151515151515
10,7.44425845666761,0.4193792903427273,1.601266381308595,32,55,75,162,0,70,5,0.46296296296296297,0.3395061728395062
11,8.19431160425704,0.44709622368270274,1.707094672243047,32,71,91,194,0,85,6,0.4690721649484536,0.36597938144329895
12,8.777411329411677,0.46806228926314214,1.7871469226410877,46,85,92,223,0,88,4,0.4125560538116592,0.3811659192825112
13,9.648582131832585,0.49854192222210847,1.903523703029869,55,102,105,262,0,102,3,0.40076335877862596,0.3893129770992366
14,10.177266349271738,0.5165909324586395,1.972438105751169,58,128,113,299,0,110,3,0.3779264214046823,0.4280936454849498
15,10.73595110279968,0.5353276822565335,2.0439784231613096,71,143,133,347,0,133,0,0.38328530259365995,0.41210374639769454
16,11.385150560675996,0.556696559534176,2.125568681857762,81,167,147,395,0,147,0,0.3721518987341772,0.42278481012658226
17,11.910862900370615,0.5737043845274011,2.190507650013713,91,191,175,457,0,175,0,0.38293216630196936,0.4179431072210066
18,12.789791462768884,0.6015914575346749,2.296985565132396,111,210,200,521,0,200,0,0.3838771593090211,0.40307101727447214
19,13.494094749513094,0.6234790361177465,2.3805563197223036,126,252,209,587,0,209,0,0.35604770017035775,0.4293015332197615
20,14.213532484950626,0.6454471727011987,2.464434659404577,129,299,231,659,0,231,0,0.3505311077389985,0.4537177541729894
21,14.787389406581026,0.662705169291779,2.5303288282049743,147,337,255,739,0,255,0,0.34506089309878213,0.456021650879567
22,15.549202074167347,0.6852747926402573,2.616503753717346,164,373,280,817,0,280,0,0.3427172582619339,0.4565483476132191
23,16.313445818809917,0.7075489460922512,2.7015505214431417,163,439,299,901,0,299,0,0.3318534961154273,0.4872364039955605
24,17.09891776167005,0.7300822124546028,2.787586629372119,192,482,318,992,0,318,0,0.32056451612903225,0.48588709677419356
25,18.180328511041047,0.7605489471725394,2.903914161931516,217,543,323,1083,0,323,0,0.2982456140350877,0.5013850415512465
26,19.011424875210178,0.7835543578084287,2.9917530025412753,221,630,325,1176,0,325,0,0.2763605442176871,0.5357142857142857
27,19.865011727887556,0.8068359406286026,3.080646318763756,240,698,330,1268,0,330,0,0.26025236593059936,0.5504731861198738
28,20.708404047836744,0.8295140987279571,3.1672356496885614,269,758,340,1367,0,340,0,0.24871982443306512,0.5544989027066569
29,21.237827845160155,0.8435925762113747,3.220989836443428,272,842,364,1478,0,364,0,0.2462787550744249,0.5696887686062246
30,21.99068522182223,0.8634128870308145,3.2966673868449297,293,894,395,1582,0,395,0,0.24968394437420985,0.5651074589127687
31,22.907908764167924,0.8872574370885892,3.38771021433825,327,961,413,1701,0,413,0,0.24279835390946503,0.5649617871840094
32,23.83706411693841,0.9110898217124694,3.478706591993066,337,1060,424,1821,0,424,0,0.2328390993959363,0.5820977484898407
33,24.48797541674346,0.9276011368482342,3.541749795238713,349,1164,434,1947,0,434,0,0.2229070364663585,0.5978428351309707
34,25.35666616827162,0.9494106967592373,3.625022660353452,387,1228,462,2077,0,462,0,0.222436206066442,0.5912373615792008
35,26.2452476239229,0.9714634562327057,3.7092241056157853,429,1319,459,2207,0,459,0,0.20797462618939738,0.5976438604440417
36,26.98999180196427,0.9897553400427229,3.7790658437994886,429,1432,488,2349,0,488,0,0.2077479778629204,0.6096211153682418
37,27.781124671978958,1.0090032554545296,3.8525578844627506,454,1524,515,2493,0,515,0,0.20657841957480946,0.6113116726835138
38,28.51810767293262,1.0267699615142185,3.920394398508833,484,1610,556,2650,0,556,0,0.20981132075471698,0.6075471698113207
39,29.470072494905477,1.0494944701992392,4.007160704397093,531,1704,569,2804,0,569,0,0.2029243937232525,0.6077032810271041
40,30.296518508046834,1.0690249346019558,4.081731568480196,532,1849,585,2966,0,585,0,0.19723533378287256,0.6233985165205664
41,31.212870904884582,1.0904736167458386,4.16362653666593,580,1953,604,3137,0,604,0,0.1925406439273191,0.6225693337583679
42,32.17213225429112,1.112702973752057,4.248502263416947,631,2063,618,3312,0,618,0,0.18659420289855072,0.6228864734299517
43,32.84630274420047,1.1281937239780628,4.307648764279877,645,2203,647,3495,0,647,0,0.18512160228898425,0.6303290414878397
44,33.72450161777426,1.1482145487396718,4.384091913369655,668,2315,702,3685,0,702,0,0.19050203527815468,0.6282225237449118
45,34.66577764242247,1.1694813932989923,4.465292592596152,720,2458,690,3868,0,690,0,0.17838676318510857,0.6354705274043433
46,35.40236521520175,1.18598957213977,4.528323820897297,751,2597,701,4049,0,701,0,0.17312916769572734,0.6413929365275377
47,35.984885383661535,1.1989638834568308,4.577862100471536,789,2723,683,4195,0,683,0,0.1628128724672229,0.6491060786650775
48,36.450816813997506,1.20929111399026,4.617293344326446,806,2829,674,4309,0,674,0,0.15641680204223718,0.6565328382455327
49,36.822267888117665,1.217492722684287,4.648608577521827,845,2918,630,4393,0,630,0,0.14340997040746642,0.6642385613475984
50,37.117683348986,1.2239957978284908,4.673438500799693,907,2959,589,4455,0,589,0,0.13221099887766555,0.6641975308641975
51,37.3206165686611,1.2284530375718392,4.690457052547024,917,3021,563,4501,0,563,0,0.12508331481892912,0.671184181293046
52,37.44798750702915,1.2312464953326303,4.701122982179131,924,3085,526,4535,0,526,0,0.11598676957001103,0.6802646085997794
53,37.535640456612164,1.2331670316342147,4.708455938967003,961,3085,511,4557,0,511,0,0.11213517665130568,0.6769804696071977
54,37.63231760140024,1.2352835613777524,4.71653723435142,995,3093,486,4574,0,486,0,0.10625273283777875,0.6762133799737647
55,37.66726775537732,1.2360482706041742,4.71945703321594,999,3109,472,4580,0,472,0,0.10305676855895196,0.6788209606986899
56,37.69967745462309,1.236757183364958,4.722163791029833,1025,3109,450,4584,0,450,0,0.09816753926701571,0.6782286212914486
57,37.706344872978626,1.2369029977779356,4.722720536970296,1025,3109,452,4586,0,452,0,0.09856083733100741,0.677932839075447
58,37.70634487297861,1.2369029977779349,4.722720536970298,1025,3109,452,4586,0,452,0,0.09856083733100741,0.677932839075447
59,37.706344872978654,1.236902997777935,4.722720536970298,1025,3109,452,4586,0,452,0,0.09856083733100741,0.677932839075447
60,37.70634487297862,1.2369029977779349,4.722720536970297,1025,3109,452,4586,0,452,0,0.09856083733100741,0.677932839075447
61,37.70634487297862,1.236902997777935,4.722720536970297,1025,3109,452,4586,0,452,0,0.09856083733100741,0.677932839075447
62,37.70634487297862,1.236902997777935,4.722720536970297,1025,3109,452,4586,0,452,0,0.09856083733100741,0.677932839075447
63,37.70634487297865,1.2369029977779349,4.7227205369702965,1025,3109,452,4586,0,452,0,0.09856083733100741,0.677932839075447
64,37.70634487297864,1.2369029977779349,4.722720536970299,1025,3109,452,4586,0,452,0,0.09856083733100741,0.677932839075447
65,37.706344872978654,1.2369029977779344,4.722720536970298,1025,3109,452,4586,0,452,0,0.09856083733100741,0.677932839075447
66,37.70634487297865,1.2369029977779349,4.722720536970297,1025,3109,452,4586,0,452,0,0.09856083733100741,0.677932839075447
67,37.70634487297865,1.2369029977779353,4.7227205369702965,1025,3109,452,4586,0,452,0,0.09856083733100741,0.677932839075447
68,37.70634487297864,1.236902997777935,4.722720536970297,1025,3109,452,4586,0,452,0,0.09856083733100741,0.677932839075447
69,37.707711403229034,1.236932882317872,4.722834641577325,1028,3109,449,4586,0,449,0,0.09790667248146533,0.677932839075447
70,37.711631189089054,1.2370186017961684,4.7231619341308235,1056,3109,421,4586,0,419,2,0.09180113388573921,0.677932839075447
71,37.71336840471626,1.2370565909872975,4.723306983769681,1106,3109,371,4586,0,347,24,0.08089838639337113,0.677932839075447
72,37.684451747924356,1.2364241695544467,4.72089228375334,1138,3109,339,4586,0,271,68,0.07392062799825556,0.677932839075447
73,37.71838607373329,1.2371663134041988,4.723725923906941,1175,3109,302,4586,0,219,83,0.06585259485390318,0.677932839075447
74,37.69633245541382,1.2366840260108536,4.72188446295053,1187,3109,290,4586,0,167,123,0.06323593545573485,0.677932839075447
75,37.715922776402735,1.2371124485747549,4.723520258194517,1210,3109,267,4586,0,138,129,0.05822067160924553,0.677932839075447
76,37.68713208682038,1.2364827966779326,4.72111613277029,1215,3109,262,4586,0,117,145,0.057130396860008724,0.677932839075447
77,37.73581323101362,1.2375473589056603,4.72518082491252,1235,3109,242,4586,0,94,148,0.05276929786306149,0.677932839075447
78,37.69437336003535,1.2366411782891051,4.7217208625584,1227,3117,242,4586,0,77,165,0.05276929786306149,0.6796772786742259
79,37.73070876906839,1.2374357557135025,4.7247547036333755,1243,3117,226,4586,0,68,158,0.04928041866550371,0.6796772786742259
80,37.69461086241772,1.2366463727852837,4.721740696089264,1232,3117,237,4586,0,48,189,0.05167902311382468,0.6796772786742259
81,37.723529563901145,1.2372787821286306,4.724155349945681,1250,3117,219,4586,0,47,172,0.047754034016572175,0.6796772786742259
82,37.69103975762563,1.2365682667745492,4.721442473139186,1236,3117,233,4586,0,43,190,0.05080680331443524,0.6796772786742259
83,37.72352956390115,1.237278782128631,4.724155349945681,1250,3117,219,4586,0,39,180,0.047754034016572175,0.6796772786742259
84,37.69103975762567,1.2365682667745492,4.721442473139186,1236,3117,233,4586,0,40,193,0.05080680331443524,0.6796772786742259
85,37.72352956390116,1.2372787821286306,4.724155349945683,1250,3117,219,4586,0,44,175,0.047754034016572175,0.6796772786742259
86,37.69103975762565,1.2365682667745492,4.721442473139188,1236,3117,233,4586,0,50,183,0.05080680331443524,0.6796772786742259
87,37.72352956390114,1.2372787821286308,4.724155349945681,1250,3117,219,4586,0,53,166,0.047754034016572175,0.6796772786742259
88,37.691039757625674,1.2365682667745492,4.721442473139188,1236,3117,233,4586,0,41,192,0.05080680331443524,0.6796772786742259
89,37.72352956390114,1.2372787821286315,4.724155349945681,1250,3117,219,4586,0,47,172,0.047754034016572175,0.6796772786742259
90,37.69103975762564,1.2365682667745495,4.721442473139188,1236,3117,233,4586,0,48,185,0.05080680331443524,0.6796772786742259
91,37.72352956390115,1.237278782128631,4.724155349945681,1250,3117,219,4586,0,42,177,0.047754034016572175,0.6796772786742259
92,37.69103975762565,1.2365682667745488,4.721442473139186,1236,3117,233,4586,0,44,189,0.05080680331443524,0.6796772786742259
93,37.72352956390116,1.2372787821286308,4.724155349945683,1250,3117,219,4586,0,50,169,0.047754034016572175,0.6796772786742259
94,37.69103975762565,1.2365682667745488,4.721442473139188,1236,3117,233,4586,0,40,193,0.05080680331443524,0.6796772786742259
95,37.72352956390114,1.237278782128631,4.724155349945681,1250,3117,219,4586,0,46,173,0.047754034016572175,0.6796772786742259
96,37.69103975762565,1.2365682667745488,4.721442473139184,1236,3117,233,4586,0,40,193,0.05080680331443524,0.6796772786742259
97,37.72352956390113,1.2372787821286308,4.724155349945681,1250,3117,219,4586,0,47,172,0.047754034016572175,0.6796772786742259
98,37.69103975762565,1.2365682667745492,4.721442473139186,1236,3117,233,4586,0,45,188,0.05080680331443524,0.6796772786742259
99,37.723529563901145,1.2372787821286308,4.724155349945681,1250,3117,219,4586,0,31,188,0.047754034016572175,0.6796772786742259
100,37.69103975762566,1.2365682667745488,4.721442473139188,1236,3117,233,4586,0,45,188,0.05080680331443524,0.6796772786742259
101,37.723529563901145,1.237278782128631,4.724155349945683,1250,3117,219,4586,0,42,177,0.047754034016572175,0.6796772786742259
102,37.69103975762565,1.2365682667745492,4.721442473139188,1236,3117,233,4586,0,38,195,0.05080680331443524,0.6796772786742259
103,37.72352956390115,1.2372787821286308,4.724155349945683,1250,3117,219,4586,0,50,169,0.047754034016572175,0.6796772786742259
104,37.69103975762565,1.2365682667745486,4.721442473139186,1236,3117,233,4586,0,43,190,0.05080680331443524,0.6796772786742259
105,37.723529563901145,1.237278782128631,4.724155349945681,1250,3117,219,4586,0,35,184,0.047754034016572175,0.6796772786742259
106,37.691039757625624,1.2365682667745488,4.721442473139186,1236,3117,233,4586,0,39,194,0.05080680331443524,0.6796772786742259
107,37.72352956390113,1.2372787821286308,4.724155349945683,1250,3117,219,4586,0,49,170,0.047754034016572175,0.6796772786742259
108,37.691039757625646,1.2365682667745488,4.721442473139186,1236,3117,233,4586,0,57,176,0.05080680331443524,0.6796772786742259
109,37.723529563901145,1.2372787821286308,4.724155349945681,1250,3117,219,4586,0,43,176,0.047754034016572175,0.6796772786742259
110,37.69103975762567,1.2365682667745492,4.721442473139185,1236,3117,233,4586,0,36,197,0.05080680331443524,0.6796772786742259
111,37.72352956390116,1.237278782128631,4.724155349945683,1250,3117,219,4586,0,43,176,0.047754034016572175,0.6796772786742259
112,37.69103975762565,1.2365682667745492,4.721442473139188,1236,3117,233,4586,0,46,187,0.05080680331443524,0.6796772786742259
0,2.3251407699364424,0.19305994851394426,0.73713798523506,0,0,25,25,0,9,16,1,0
1,2.7195696311825164,0.21431840757878728,0.8183066471190059,10,0,25,35,0,5,20,0.7142857142857143,0
2,3.3593980938726973,0.2467366512548013,0.9420853957001503,12,9,20,41,0,4,16,0.4878048780487805,0.21951219512195122
3,3.670728863832662,0.261754539990172,0.9994264254170203,12,13,27,52,0,8,19,0.5192307692307693,0.25
4,4.182848150410256,0.28556660449646165,1.0903452171683081,12,21,29,62,0,10,19,0.46774193548387094,0.3387096774193548
5,4.838760908006763,0.31468940943075063,1.201541381462866,22,21,28,71,0,15,13,0.39436619718309857,0.29577464788732394
6,5.376671275172036,0.33759940699602264,1.2890159176211773,16,37,32,85,0,24,8,0.3764705882352941,0.43529411764705883
7,5.8786634000921065,0.3582985752548422,1.3680491055184885,19,43,38,100,0,31,7,0.38,0.43
8,6.483034712754332,0.3824531566642955,1.4602756890818551,19,52,51,122,0,44,7,0.4180327868852459,0.4262295081967213
9,7.049410499655244,0.40441558701599367,1.544132241333794,26,60,61,147,0,55,6,0.41496598639455784,0.40816326530612246
10,7.705090248472024,0.4291190931923241,1.638454719461601,29,74,71,174,0,68,3,0.40804597701149425,0.42528735632183906
11,8.106045516711157,0.44387979540631217,1.6948137642786467,40,82,81,203,0,77,4,0.39901477832512317,0.4039408866995074
12,8.721041208868206,0.4660561510950437,1.7794871223628939,45,95,97,237,0,93,4,0.4092827004219409,0.4008438818565401
13,9.634040370334981,0.49804088141994446,1.9016106381488787,57,114,105,276,0,103,2,0.3804347826086957,0.41304347826086957
14,10.464014501705835,0.5262493515811123,2.009315706036974,59,143,111,313,0,109,2,0.3546325878594249,0.45686900958466453
15,11.00596395212494,0.5442662558494479,2.078107522334254,70,163,122,355,0,120,2,0.3436619718309859,0.4591549295774648
16,11.387414568747529,0.5567703588062617,2.125850460896635,76,185,137,398,0,133,4,0.3442211055276382,0.4648241206030151
17,12.13612501368698,0.5809151633322169,2.2180397145411916,92,198,159,449,0,157,2,0.35412026726057905,0.44097995545657015
18,12.846916311375068,0.6033814418636333,2.3038200507520528,97,233,181,511,0,179,2,0.3542074363992172,0.45596868884540115
19,13.639864901080058,0.6279610847741294,2.3976695964103123,125,257,194,576,0,192,2,0.3368055555555556,0.4461805555555556
20,14.534012414977974,0.6551132294319025,2.5013414214672642,129,297,213,639,0,213,0,0.3333333333333333,0.4647887323943662
21,15.395720554322578,0.6807579131189196,2.5992574864540567,134,347,221,702,0,221,0,0.3148148148148148,0.4943019943019943
22,16.003768555417444,0.6985661323897504,2.6672525054881375,150,398,231,779,0,231,0,0.29653401797175866,0.5109114249037228
23,16.766215389046735,0.7205808438851381,2.7513086766523474,188,425,246,859,0,246,0,0.28637951105937137,0.4947613504074505
24,17.45314218797073,0.7401307300341047,2.8259536964938547,194,474,272,940,0,272,0,0.28936170212765955,0.5042553191489362
25,18.169142379852886,0.7602369442671848,2.9027228781110703,214,515,293,1022,0,293,0,0.28669275929549903,0.5039138943248532
26,18.80358391805264,0.7778331358738936,2.9699083369730497,213,580,311,1104,0,311,0,0.2817028985507246,0.5253623188405797
27,19.550058430232635,0.7982851644756259,3.047997900725118,221,630,342,1193,0,342,0,0.28667225481978204,0.5280804694048616
28,20.142718840016972,0.8143380836276873,3.109290864760262,239,688,370,1297,0,370,0,0.28527370855821127,0.5304548959136469
29,20.662177372764557,0.8282791746817063,3.1625204851483337,273,735,397,1405,0,397,0,0.2825622775800712,0.5231316725978647
30,21.33741423418868,0.846227648561363,3.231051021779748,276,787,455,1518,0,455,0,0.2997364953886693,0.5184453227931489
31,22.213471451768008,0.8692345386976454,3.31889551139101,306,848,485,1639,0,485,0,0.29591214154972545,0.5173886516168396
32,23.045885013042362,0.8908165540322344,3.4012995699412585,339,927,505,1771,0,505,0,0.28514963297571994,0.52343308865048
33,24.18527325196919,0.9199410901412122,3.512502344175537,372,1017,503,1892,0,503,0,0.26585623678646936,0.5375264270613108
34,25.036627164200052,0.9414051428709801,3.594456000052833,377,1146,496,2019,0,496,0,0.2456661713719663,0.5676077265973254
35,25.81470480876052,0.960809880875392,3.6685468178878584,412,1235,500,2147,0,500,0,0.2328830926874709,0.5752212389380531
36,26.608101955245626,0.9803969446878239,3.7433337888080542,423,1329,542,2294,0,542,0,0.23626852659110723,0.5793374019180471
37,27.55495115950155,1.0035194220570576,3.831619611490582,467,1412,559,2438,0,559,0,0.22928630024610336,0.579163248564397
38,28.444750410141456,1.0250084289662806,3.913668546962162,478,1538,568,2584,0,568,0,0.21981424148606812,0.5952012383900929
39,29.203418159107237,1.0431541173152075,3.98295208429443,493,1657,590,2740,0,590,0,0.21532846715328466,0.6047445255474453
40,30.03326798164552,1.0628233307227157,4.058052717304913,528,1755,611,2894,0,611,0,0.21112646855563233,0.6064270905321355
41,31.020375572481157,1.0859855657462858,4.146490341940362,552,1858,635,3045,0,635,0,0.20853858784893267,0.6101806239737274
42,31.825853371455306,1.1047043315040672,4.217961993015529,570,1998,645,3213,0,645,0,0.20074696545284781,0.6218487394957983
43,32.62647822967695,1.1231544537554463,4.288407914338973,591,2124,669,3384,0,669,0,0.1976950354609929,0.6276595744680851
44,33.3397226706016,1.1394641706796766,4.350681378958762,619,2243,707,3569,0,707,0,0.19809470439899132,0.6284673578033062
45,34.16816354535417,1.1582628043528724,4.422457980256423,646,2345,759,3750,0,759,0,0.2024,0.6253333333333333
46,34.95841087689777,1.1760536662507897,4.490386725684833,685,2473,759,3917,0,759,0,0.19377074291549656,0.6313505233597141
47,35.571868201786906,1.1897721574013853,4.542766419168929,712,2615,730,4057,0,730,0,0.17993591323638156,0.6445649494700517
48,35.93395698191328,1.1978323764214733,4.573541800881992,748,2721,700,4169,0,700,0,0.167905972655313,0.6526745022787239
49,36.32182331869639,1.2064364392889373,4.606393677285034,787,2792,674,4253,0,674,0,0.15847636962144368,0.6564777803903127
50,36.588015095269526,1.2123236707346419,4.62887219735045,813,2871,643,4327,0,643,0,0.14860180263461983,0.6635082042985903
51,36.816997956142906,1.2173765564394325,4.648165033677832,856,2913,623,4392,0,623,0,0.1418488160291439,0.6632513661202186
52,36.96272518024699,1.2205868141817975,4.660422381421411,894,2951,600,4445,0,600,0,0.13498312710911137,0.6638920134983127
53,37.13745986707228,1.2244305272944969,4.675098376942624,894,2999,590,4483,0,590,0,0.1316082980147223,0.66897167075619
54,37.32540756180215,1.2285581695284018,4.690858465472078,932,3021,557,4510,0,557,0,0.12350332594235033,0.6698447893569844
55,37.4118266055023,1.2304537486499312,4.698096131208828,924,3085,526,4535,0,526,0,0.11598676957001103,0.6802646085997794
0,2.325140769936442,0.1930599485139443,0.7371379852350599,0,0,25,25,0,5,20,1,0
1,2.765929726722634,0.21674717533468146,0.8275801240051474,13,0,18,31,0,7,11,0.5806451612903226,0
2,3.232514920755282,0.2404841053799172,0.9182120387233204,10,9,20,39,0,14,6,0.5128205128205128,0.23076923076923078
3,3.727301073079279,0.26443706893508917,1.0096688086612493,10,13,27,50,0,21,6,0.54,0.26
4,4.190784549184942,0.2859277068335554,1.091723971546302,9,21,32,62,0,24,8,0.5161290322580645,0.3387096774193548
5,4.667391299084578,0.30721481846607657,1.1730020341432017,16,21,39,76,0,34,5,0.5131578947368421,0.27631578947368424
6,5.12756320784804,0.3270895733054431,1.2488874617116918,15,33,44,92,0,40,4,0.4782608695652174,0.358695652173913
7,5.572805876257007,0.3457604344207535,1.320176204151968,21,35,59,115,0,54,5,0.5130434782608696,0.30434782608695654
8,6.23809059716077,0.37275814088235165,1.423258356096252,33,41,67,141,0,63,4,0.475177304964539,0.2907801418439716
9,6.8547324154514575,0.39693526912520344,1.5155710275689587,35,57,83,175,0,81,2,0.4742857142857143,0.32571428571428573
10,7.614370256344065,0.4257441401631773,1.6255685351684945,54,67,90,211,0,90,0,0.4265402843601896,0.3175355450236967
11,8.402556440183897,0.45463930314964124,1.7358955211168128,50,95,109,254,0,109,0,0.42913385826771655,0.37401574803149606
12,9.167154865465026,0.48181730851158455,1.8396660870442318,65,117,113,295,0,113,0,0.38305084745762713,0.39661016949152544
13,9.844244811215349,0.505259268243399,1.929171751474795,77,145,115,337,0,115,0,0.34124629080118696,0.43026706231454004
14,10.519312049268887,0.5281017144739234,2.0163883643549796,79,177,125,381,0,125,0,0.32808398950131235,0.4645669291338583
15,11.161606301625994,0.5493854479162747,2.097653528407595,94,192,153,439,0,153,0,0.34851936218678814,0.43735763097949887
16,11.957110647060059,0.5751884860379656,2.1961742194176868,112,222,164,498,0,164,0,0.3293172690763052,0.4457831325301205
17,12.733356336825572,0.5998204666112272,2.290223599788322,131,258,174,563,0,174,0,0.30905861456483125,0.458259325044405
18,13.524668720815285,0.6244204374956768,2.3841507613471298,152,291,189,632,0,189,0,0.2990506329113924,0.46044303797468356
19,14.334024284083421,0.649089786863724,2.4783428225705832,157,346,194,697,0,194,0,0.2783357245337159,0.4964131994261119
0,2.325140769936443,0.19305994851394426,0.7371379852350601,0,0,25,25,0,5,20,1,0
1,2.560630078413466,0.2058846239931825,0.7861049279739697,12,0,16,28,0,4,12,0.5714285714285714,0
2,3.022141348630325,0.22993365016635403,0.8779284824533518,9,9,16,34,0,8,8,0.47058823529411764,0.2647058823529412
3,3.3993729065267404,0.2486901347356928,0.9495441508090086,10,9,26,45,0,14,12,0.5777777777777777,0.2
4,3.8621609265096963,0.2707777212048475,1.0338785718730539,12,13,32,57,0,20,12,0.5614035087719298,0.22807017543859648
5,4.354098458378763,0.29330863499376914,1.1199056972489365,13,21,37,71,0,27,10,0.5211267605633803,0.29577464788732394
6,4.922822142738505,0.3183235592223076,1.215417226121538,18,25,43,86,0,33,10,0.5,0.29069767441860467
7,5.549461647291614,0.34479417593350203,1.3164868535642806,22,36,49,107,0,39,10,0.45794392523364486,0.3364485981308411
8,6.185494426981792,0.37065992351411525,1.4152469806902586,30,43,57,130,0,49,8,0.43846153846153846,0.33076923076923076
9,6.871616247113983,0.39758679371485367,1.5180586669112597,32,55,75,162,0,64,11,0.46296296296296297,0.3395061728395062
10,7.515383896146156,0.4220463335069375,1.6114496370264884,52,64,80,196,0,67,13,0.40816326530612246,0.32653061224489793
11,8.301710331027541,0.45099431653023825,1.721978299479091,53,87,89,229,0,77,12,0.388646288209607,0.3799126637554585
12,9.113714803215226,0.47994297715489986,1.8325095491368895,57,111,98,266,0,85,13,0.3684210526315789,0.41729323308270677
13,9.874691476527444,0.5063005223805764,1.9331474490894742,71,134,96,301,0,85,11,0.31893687707641194,0.44518272425249167
14,10.538840331308066,0.5287550988367159,2.018883104649279,72,163,106,341,0,95,11,0.31085043988269795,0.4780058651026393
15,11.352743970103749,0.5556396736851872,2.1215332995252596,96,176,110,382,0,104,6,0.2879581151832461,0.4607329842931937
16,12.066759267635408,0.5786995139178737,2.2095799622318806,87,216,129,432,0,123,6,0.2986111111111111,0.5
17,12.778584170792023,0.6012399690743525,2.295643518283891,100,246,138,484,0,129,9,0.28512396694214875,0.5082644628099173
18,13.632732207570626,0.6277421459283917,2.396833648090222,122,265,156,543,0,150,6,0.287292817679558,0.4880294659300184
19,14.324998693827865,0.6488172868169727,2.4773023678466224,127,305,169,601,0,162,7,0.281198003327787,0.5074875207986689
20,14.920095320617449,0.6666641226333884,2.545444831872938,133,347,193,673,0,185,8,0.2867756315007429,0.5156017830609212
21,15.67619552624775,0.6890009165524243,2.630730772291075,155,374,208,737,0,200,8,0.28222523744911804,0.5074626865671642
22,16.305401722549636,0.7073163338962646,2.7006623657857367,164,414,226,804,0,220,6,0.2810945273631841,0.5149253731343284
23,17.043574392374957,0.7285060098827116,2.781568401370355,182,450,248,880,0,246,2,0.2818181818181818,0.5113636363636364
24,17.69457583511254,0.7469406973319306,2.851955389812825,191,506,266,963,0,262,4,0.2762201453790239,0.5254413291796469
25,18.297414239308033,0.7638108653700003,2.9163687586854556,196,546,309,1051,0,307,2,0.2940057088487155,0.5195052331113226
26,19.03745248156347,0.7842693452061194,2.994482954423363,223,593,326,1142,0,324,2,0.28546409807355516,0.5192644483362522
27,19.942224132610953,0.8089252910424097,3.0886238385255638,243,647,351,1241,0,347,4,0.28283642224012895,0.5213537469782433
28,20.657772843598245,0.828161461711379,3.162071035625267,271,710,354,1335,0,350,4,0.2651685393258427,0.5318352059925093
29,21.36963688104789,0.8470793867630689,3.234303113095355,286,774,376,1436,0,372,4,0.2618384401114206,0.5389972144846796
30,22.021890850225663,0.8642295047087758,3.2997853816153233,298,846,404,1548,0,398,6,0.26098191214470284,0.5465116279069767
31,22.9800895337081,0.889120238854478,3.394822730171643,335,893,434,1662,0,430,4,0.2611311672683514,0.5373044524669074
32,23.846450520798488,0.9113289813625158,3.4796197470205135,351,991,438,1780,0,436,2,0.24606741573033708,0.5567415730337079
33,24.45827305703524,0.9268509042691543,3.5388852708458653,361,1084,462,1907,0,462,0,0.2422653382275826,0.5684320922915574
34,25.233037873806584,0.9463222358053824,3.61323035489328,402,1132,504,2038,0,504,0,0.24730127576054955,0.5554465161923454
35,25.961065284166576,0.9644380982954681,3.6824000116736055,418,1234,517,2169,0,517,0,0.23835869064084833,0.5689257722452743
36,26.622875353705464,0.9807598029576147,3.744719247656348,423,1313,577,2313,0,577,0,0.24945957630782534,0.567661046260268
37,27.471263616683906,1.0014865232111805,3.8238576340790535,500,1374,587,2461,0,587,0,0.2385209264526615,0.5583096302316132
38,28.292346711114725,1.0213439002654612,3.8996767101044894,507,1497,602,2606,0,602,0,0.23100537221795855,0.5744435917114351
39,29.27261171671984,1.0448012092369994,3.9892409807230913,516,1612,636,2764,0,636,0,0.2301013024602026,0.5832127351664255
40,30.169761550792376,1.0660410710844097,4.070338635049565,528,1749,656,2933,0,656,0,0.2236617797476986,0.5963177633822025
41,31.030219159406023,1.0862152949232826,4.14736748970708,579,1855,662,3096,0,662,0,0.21382428940568476,0.5991602067183462
42,31.86442315311824,1.1055966794713894,4.22136913979985,597,1973,703,3273,0,703,0,0.21478765658417354,0.6028108768713718
43,32.78552104949858,1.1268014882770256,4.30233295523955,623,2101,731,3455,0,731,0,0.21157742402315485,0.6081041968162084
44,33.68232026080077,1.1472569195685152,4.380435511079787,668,2238,733,3639,0,733,0,0.2014289640010992,0.6150041220115416
45,34.57771125377298,1.167499887488398,4.45772684313752,720,2359,738,3817,0,738,0,0.19334555933979566,0.6180246266701598
46,35.23511832671517,1.1822514119157268,4.514050845496411,761,2501,717,3979,0,717,0,0.18019602915305352,0.6285498869062579
47,35.81055487853725,1.1950884580523498,4.563065021654425,768,2627,725,4120,0,725,0,0.17597087378640777,0.637621359223301
48,36.17301376346916,1.203139026236009,4.593803554719306,783,2734,712,4229,0,712,0,0.16836131473161503,0.6464885315677465
49,36.432815102332256,1.2088929317437387,4.615773012112458,813,2797,700,4310,0,700,0,0.16241299303944315,0.6489559164733179
50,36.70666201334625,1.2149431230199348,4.638873742439747,831,2862,671,4364,0,671,0,0.15375802016498624,0.655820348304308
51,36.89698722433631,1.2191391812911825,4.654895055839062,878,2911,615,4404,0,615,0,0.1396457765667575,0.6609900090826522
52,36.96907414281556,1.2207265808994716,4.660956036161617,873,2961,609,4443,0,609,0,0.13706954760297096,0.6664415935178933
53,37.16133859106931,1.2249553290513533,4.677102165468803,889,2991,595,4475,0,595,0,0.1329608938547486,0.6683798882681564
54,37.328371094159365,1.2286231980429088,4.691106756163834,898,3037,569,4504,0,569,0,0.12633214920071048,0.6742895204262878
55,37.4184682537346,1.23059937103595,4.698652143955446,909,3086,531,4526,0,531,0,0.11732213875386655,0.6818382677861247
56,37.47939697437954,1.2319348704195128,4.703751323419959,947,3087,509,4543,0,509,0,0.11204050187101035,0.6795069337442219
57,37.52735465118728,1.2329855479755945,4.707763001361364,977,3087,497,4561,0,497,0,0.1089673317254988,0.6768252576189432
58,37.60080745506856,1.234593916550684,4.7139040450117,992,3095,490,4577,0,490,0,0.10705702425169325,0.6762071225693685
59,37.65683559009593,1.235820039642126,4.718585605906299,1001,3111,478,4590,0,478,0,0.10413943355119826,0.6777777777777778
60,37.71694199671308,1.2371347359689024,4.723605355517627,1029,3111,456,4596,0,456,0,0.09921671018276762,0.6768929503916449
61,37.71756174037997,1.2371482878685263,4.723657099134374,1030,3111,457,4598,0,457,0,0.09939103958242715,0.6765985210961287
0,2.325140769936443,0.19305994851394426,0.7371379852350601,0,0,25,25,0,3,22,1,0
1,2.6065671519165625,0.20833966610075158,0.7954787251119605,10,0,21,31,0,3,18,0.6774193548387096,0
2,3.0853884559353255,0.233130584213677,0.8901349579067667,9,9,19,37,0,4,15,0.5135135135135135,0.24324324324324326
3,3.5713020968356295,0.2570062852081352,0.9812967253401524,16,9,17,42,0,6,11,0.40476190476190477,0.21428571428571427
4,3.9845694066020942,0.27646932312341266,1.0556101428348486,8,21,22,51,0,7,15,0.43137254901960786,0.4117647058823529
5,4.848284615804615,0.3151021911012718,1.2031174569321288,16,21,23,60,0,11,12,0.38333333333333336,0.35
6,5.455489762510115,0.34089072254168484,1.301582758795524,12,34,25,71,0,14,11,0.352112676056338,0.4788732394366197
7,6.016332390927901,0.3638708231908499,1.3893249612741543,16,37,32,85,0,20,12,0.3764705882352941,0.43529411764705883
8,6.735990132772249,0.39233794534067656,1.4980176094825832,17,43,43,103,0,28,15,0.4174757281553398,0.4174757281553398
9,7.6465349302588255,0.4269422518075266,1.6301431432651015,25,50,44,119,0,34,10,0.3697478991596639,0.42016806722689076
10,8.251286660379016,0.4491662697640575,1.7149984845536739,25,65,48,138,0,36,12,0.34782608695652173,0.47101449275362317
11,8.836566827126392,0.4701629427328395,1.7951675995253866,27,73,55,155,0,46,9,0.3548387096774194,0.47096774193548385
12,9.168317598605547,0.48185804911346247,1.8398216420695834,31,83,61,175,0,52,9,0.3485714285714286,0.4742857142857143
13,10.08404830113665,0.5134316418943726,1.960375359960332,42,87,71,200,0,64,7,0.355,0.435
14,10.762955966708368,0.536225003620034,2.047404559276494,43,107,78,228,0,68,10,0.34210526315789475,0.4692982456140351
15,11.317437878656381,0.5544870802459807,2.1171324882119262,46,123,89,258,0,78,11,0.3449612403100775,0.47674418604651164
16,12.011677873903796,0.5769371033749301,2.202850758340642,50,136,103,289,0,97,6,0.356401384083045,0.47058823529411764
17,12.66986172183333,0.5978248109532823,2.2826038236398047,61,155,104,320,0,99,5,0.325,0.484375
18,13.527429726625002,0.6245054165236364,2.3844752267266114,71,168,117,356,0,111,6,0.32865168539325845,0.47191011235955055
19,14.215071515417932,0.6454937642124446,2.4646125542656985,75,194,124,393,0,118,6,0.3155216284987277,0.49363867684478374
20,14.72722390810159,0.6609063810293553,2.5234607275666288,82,217,135,434,0,130,5,0.31105990783410137,0.5
21,15.05444174805437,0.6706600786394045,2.5607021184413625,83,237,159,479,0,152,7,0.33194154488517746,0.49478079331941544
22,15.500455460021287,0.6838418228934897,2.6110324146842343,98,248,184,530,0,174,10,0.3471698113207547,0.4679245283018868
23,16.034222330266,0.6994520584869862,2.670635132404857,99,272,214,585,0,207,7,0.3658119658119658,0.46495726495726497
24,16.7914572914865,0.7213038959690883,2.754069420972882,116,297,228,641,0,224,4,0.35569422776911075,0.46333853354134164
25,18.011308710194527,0.7558278061997181,2.885887987308016,126,331,238,695,0,238,0,0.3424460431654676,0.4762589928057554
26,18.837551596688208,0.7787695969847425,2.9734839157599264,128,395,237,760,0,237,0,0.3118421052631579,0.5197368421052632
27,19.62611080108321,0.8003541159947112,3.0558975337979875,151,429,243,823,0,243,0,0.29526123936816523,0.5212636695018226
28,20.539522784871625,0.8249980419824856,3.149992523933126,164,467,254,885,0,254,0,0.28700564971751413,0.5276836158192091
29,20.617592772580583,0.8270872451454477,3.1579694814644355,165,521,267,953,0,267,0,0.2801678908709339,0.546694648478489
30,21.216973310035705,0.8430402406460856,3.2188809188305094,185,523,327,1035,0,327,0,0.3159420289855073,0.5053140096618357
31,22.097248119070308,0.8661999346245762,3.3073088412938367,204,565,349,1118,0,349,0,0.31216457960644006,0.5053667262969589
32,22.753048137467502,0.8832542630553611,3.372425368029559,228,621,351,1200,0,351,0,0.2925,0.5175
33,23.328374141008897,0.8980813266902501,3.429037792817317,226,679,382,1287,0,382,0,0.29681429681429683,0.5275835275835276
34,24.023623676219295,0.9158373742061541,3.496833610605313,254,717,414,1385,0,414,0,0.29891696750902524,0.5176895306859206
35,24.34757608964493,0.9240522020701911,3.5281993169952757,274,770,443,1487,0,443,0,0.29791526563550774,0.5178211163416274
36,25.276709692414038,0.9474138126809263,3.617398193872626,293,803,496,1592,0,496,0,0.31155778894472363,0.5043969849246231
37,25.712059966771935,0.9582612649583959,3.6588157389320584,298,890,516,1704,0,516,0,0.3028169014084507,0.5223004694835681
38,26.573738512319093,0.9795526637437592,3.740110170657991,328,930,563,1821,0,563,0,0.30917078528281167,0.5107084019769358
39,27.339142448220656,0.9982728897237843,3.811587397127177,344,1017,587,1948,0,587,0,0.3013347022587269,0.5220739219712526
40,27.351918743733727,0.9985838781725448,3.8127748075679,358,1102,621,2081,0,621,0,0.2984142239308025,0.5295530994714079
41,28.624373403004224,1.0293190509227133,3.9301272853412663,375,1126,715,2216,0,715,0,0.32265342960288806,0.5081227436823105
42,29.325075046605342,1.0460491878571576,3.994005990000056,402,1256,699,2357,0,699,0,0.2965634280865507,0.532880780653373
43,30.170144919476687,1.066050101890452,4.070373116308996,409,1352,740,2501,0,740,0,0.2958816473410636,0.5405837664934027
44,31.11360807954397,1.0881604482201974,4.154794438658936,441,1447,761,2649,0,761,0,0.2872782181955455,0.546243865609664
45,31.191683145743916,1.0899800744681871,4.161742102514897,461,1556,783,2800,0,783,0,0.27964285714285714,0.5557142857142857
46,31.321632357020185,1.0930053228261156,4.173293050790623,498,1578,876,2952,0,876,0,0.2967479674796748,0.5345528455284553
47,31.757305811275945,1.1031175294179436,4.211903294141239,503,1628,966,3097,0,966,0,0.3119147562156926,0.5256700032289312
48,32.05115622811318,1.1099118441226759,4.237845223013853,500,1728,989,3217,0,989,0,0.3074292819396954,0.5371464096984768
49,32.529543422801815,1.120928720786283,4.2799096611839875,528,1784,1015,3327,0,1015,0,0.30507965133754134,0.5362188157499248
50,33.438852757647794,1.1417217235659158,4.359301126342587,569,1882,976,3427,0,976,0,0.2847971987160782,0.5491683688357164
51,33.78148359858539,1.1495075577851082,4.389028856997686,588,2023,902,3513,0,902,0,0.25676060347281526,0.5758610873896954
52,33.967628256807025,1.1537264106229363,4.4051372041966665,582,2110,897,3589,0,897,0,0.24993034271384787,0.58790749512399
53,33.97913810242718,1.1539870207730614,4.406132261133507,601,2169,896,3666,0,896,0,0.24440807419530824,0.5916530278232406
54,34.142467380357516,1.157682017233682,4.420240429437694,630,2204,903,3737,0,903,0,0.24163767728124164,0.5897778967085898
55,34.29867212858881,1.161210327319945,4.43371215885797,630,2261,915,3806,0,915,0,0.24040987913820283,0.594062007356805
56,34.45416218037777,1.1647171784388117,4.4471019540390975,657,2322,899,3878,0,899,0,0.23182052604435277,0.5987622485817432
57,34.72591123327241,1.1708334433470446,4.4704549655069,700,2362,883,3945,0,883,0,0.2238276299112801,0.5987325728770596
58,35.06685181671796,1.1784844884417902,4.499668046777743,699,2445,869,4013,0,869,0,0.21654622476949914,0.6092698729130327
59,35.461026917500305,1.1872993333645778,4.533324727392026,713,2516,846,4075,0,846,0,0.20760736196319018,0.6174233128834355
60,35.79576435644003,1.1947593707336368,4.561808506437521,755,2607,768,4130,0,768,0,0.18595641646489103,0.6312348668280872
61,35.81032626382262,1.195083371747517,4.563045601217792,758,2676,753,4187,0,753,0,0.17984236923811797,0.6391210890852639
62,36.12393837179506,1.2020505927756837,4.589647717870791,788,2693,753,4234,0,753,0,0.17784600850259802,0.6360415682569674
63,36.1995041672312,1.2037263471228683,4.596046052650953,795,2766,722,4283,0,722,0,0.16857342983889798,0.6458090123745038
64,36.366401724601076,1.207423357773202,4.610161911497676,824,2793,711,4328,0,711,0,0.16427911275415896,0.6453327171903882
65,36.71774700986675,1.2151877100930124,4.639807620355137,839,2848,680,4367,0,680,0,0.1557133043279139,0.6521639569498512
66,36.976099045493264,1.2208812185087266,4.661546470669682,882,2902,617,4401,0,617,0,0.14019541013406045,0.6593955919109293
67,37.03646106592607,1.2222095508249378,4.666618284967943,872,2970,592,4434,0,592,0,0.13351375732972484,0.6698240866035182
68,37.17560016579789,1.2252687134342828,4.678298724021807,888,2993,583,4464,0,583,0,0.13060035842293907,0.6704749103942652
69,37.25518268276241,1.2270167275538624,4.684972959751111,922,3013,556,4491,0,555,1,0.12380316187931419,0.6708973502560677
70,37.38021167930753,1.2297604529929287,4.695449002336637,948,3036,533,4517,0,522,11,0.11799867168474651,0.6721275182643347
71,37.54378058826512,1.2333453116028312,4.709136644301718,1017,3071,444,4532,0,423,21,0.09796999117387467,0.6776257722859664
72,37.55998881659898,1.2337002555115366,4.7104918846804145,1066,3079,399,4544,0,357,42,0.0878080985915493,0.6775968309859155
73,37.626039581103214,1.2351461732424724,4.716012661471261,1084,3079,393,4556,0,329,64,0.08625987708516242,0.6758121158911325
74,37.64107778927424,1.2354752564769105,4.717269161093661,1100,3095,370,4565,0,298,72,0.08105147864184009,0.6779846659364732
75,37.69754536193996,1.2367105533321165,4.721985749086261,1142,3095,333,4570,0,257,76,0.07286652078774616,0.6772428884026258
76,37.69594982821291,1.236675657561953,4.721852510691099,1151,3095,327,4573,0,233,94,0.07150666958233107,0.6767986004810846
77,37.71297847531256,1.2370480641157835,4.723274426623898,1156,3095,322,4573,0,225,97,0.07041329542969604,0.6767986004810846
78,37.69722329610155,1.2367035094996943,4.721958854453379,1158,3095,320,4573,0,215,105,0.06997594576864202,0.6767986004810846
79,37.71193245494732,1.2370251898781068,4.723187088625504,1167,3095,311,4573,0,204,107,0.06800787229389897,0.6767986004810846
80,37.68816592839628,1.2365054095505998,4.721202472829564,1167,3095,311,4573,0,193,118,0.06800787229389897,0.6767986004810846
81,37.71364674806979,1.2370626777070475,4.723330223972364,1173,3095,305,4573,0,183,122,0.06669582331073694,0.6767986004810846
82,37.686455950540534,1.2364680076623054,4.721059665619711,1170,3095,308,4573,0,195,113,0.06735184780231795,0.6767986004810846
83,37.7186383706237,1.2371718303045456,4.723746988435537,1181,3095,297,4573,0,184,113,0.06494642466652088,0.6767986004810846
84,37.67834271575004,1.2362905413377414,4.720382066925919,1179,3095,299,4573,0,171,128,0.06538377432757489,0.6767986004810846
85,37.715390176211066,1.2371008020723506,4.723475789730792,1194,3095,284,4573,0,170,114,0.062103651869669804,0.6767986004810846
86,37.67475303671856,1.2362120177725022,4.720082249676824,1194,3095,284,4573,0,157,127,0.062103651869669804,0.6767986004810846
87,37.722050947723645,1.237246450894942,4.724031903417053,1197,3095,281,4573,0,135,146,0.06144762737808878,0.6767986004810846
88,37.670111032564414,1.2361104710918838,4.719694525987194,1201,3095,277,4573,0,144,133,0.06057292805598076,0.6767986004810846
89,37.72666151870479,1.2373472636599354,4.724416824883388,1206,3095,272,4573,0,134,138,0.05947955390334572,0.6767986004810846
90,37.67548802492988,1.2362280957067908,4.720143638153199,1205,3103,265,4573,0,110,155,0.05794883008965668,0.6785479991253007
91,37.73081188162264,1.2374380102007627,4.724763311675641,1204,3103,266,4573,0,114,152,0.05816750492018369,0.6785479991253007
92,37.6715680110696,1.236142343837104,4.719816221923489,1210,3103,260,4573,0,116,144,0.05685545593702165,0.6785479991253007
93,37.74490202135315,1.2377460624016037,4.725939510987943,1217,3103,253,4573,0,95,158,0.0553247321233326,0.6785479991253007
94,37.677081662760536,1.2362629563208618,4.720276742316017,1204,3119,250,4573,0,90,160,0.054668707631751585,0.6820467964137328
95,37.74484644780936,1.2377448474745862,4.725934872175695,1210,3119,244,4573,0,78,166,0.053356658648589544,0.6820467964137328
96,37.671357608158665,1.2361377411052419,4.7197986478563765,1212,3119,242,4573,0,77,165,0.05291930898753554,0.6820467964137328
97,37.74180390678816,1.2376783317261326,4.725680902954327,1214,3119,240,4573,0,68,172,0.052481959326481524,0.6820467964137328
98,37.68158178510383,1.2363613932408763,4.720652592374254,1218,3119,236,4573,0,61,175,0.0516072600043735,0.6820467964137328
99,37.73790782624506,1.2375931533662325,4.725355676489253,1224,3119,230,4573,0,59,171,0.050295211021211456,0.6820467964137328
100,37.66892439398322,1.2360845119775883,4.719595409368975,1225,3119,229,4573,0,54,175,0.05007653619068445,0.6820467964137328
101,37.74269265939597,1.2376977617376674,4.725755090271094,1230,3119,224,4573,0,52,172,0.04898316203804942,0.6820467964137328
0,2.325140769936443,0.19305994851394426,0.7371379852350599,0,0,25,25,0,6,19,1,0
1,2.6496558666164107,0.21062940448719256,0.8042213625874626,11,0,19,30,0,5,14,0.6333333333333333,0
2,3.3529132715314254,0.24641902321142697,0.9408726340799938,11,9,19,39,0,7,12,0.48717948717948717,0.23076923076923078
3,3.9527394474205,0.2749950081926613,1.0499809403719793,14,12,22,48,0,10,12,0.4583333333333333,0.25
4,4.4823142100388,0.2990388060197549,1.1417845320754276,11,21,29,61,0,18,11,0.47540983606557374,0.3442622950819672
5,4.930702156762569,0.3186631646101094,1.2167139012385995,13,26,35,74,0,21,14,0.47297297297297297,0.35135135135135137
6,5.472180018159923,0.3415856379921941,1.3042360723338322,15,31,48,94,0,33,15,0.5106382978723404,0.32978723404255317
7,5.922061949298692,0.3600598110510221,1.3747738240129934,26,37,49,112,0,33,16,0.4375,0.33035714285714285
8,6.412335789407683,0.37966758768833686,1.4496398802645591,25,47,60,132,0,47,13,0.45454545454545453,0.3560606060606061
9,6.989621304774023,0.4021256563796953,1.535388869813382,29,57,67,153,0,56,11,0.43790849673202614,0.37254901960784315
10,7.631291460945333,0.42637465307024125,1.6279759480863756,40,68,71,179,0,62,9,0.39664804469273746,0.37988826815642457
11,8.398141604406362,0.4544800394238003,1.7352874232545101,45,83,81,209,0,74,7,0.3875598086124402,0.39712918660287083
12,8.93485369714011,0.47364284621895153,1.8084545037450872,41,106,97,244,0,94,3,0.3975409836065574,0.4344262295081967
13,9.512822760693178,0.49385443164359044,1.885626011730073,47,121,112,280,0,111,1,0.4,0.43214285714285716
14,10.521984498618538,0.5281911541207539,2.0167298611883333,61,139,123,323,0,121,2,0.38080495356037153,0.43034055727554177
15,10.998321734878347,0.5440142783764571,2.0771454265282894,68,167,134,369,0,132,2,0.36314363143631434,0.45257452574525747
16,11.712616038728967,0.5673206905498456,2.1661335457357733,82,187,152,421,0,152,0,0.36104513064133015,0.44418052256532065
17,12.488529220077998,0.5921070262897418,2.2607722821971965,96,213,172,481,0,172,0,0.3575883575883576,0.44282744282744285
18,13.19705990822185,0.6142957027783063,2.3454926833353507,103,253,182,538,0,182,0,0.3382899628252788,0.47026022304832715
19,13.917012449520524,0.6364388695229075,2.430039319996556,113,292,197,602,0,197,0,0.3272425249169435,0.4850498338870432
20,14.572514050443958,0.6562696803323199,2.5057569612688573,126,328,214,668,0,214,0,0.3203592814371258,0.49101796407185627
21,15.373498811184966,0.6801026977557422,2.5967557550673788,133,370,240,743,0,240,0,0.32301480484522205,0.4979811574697174
22,15.972268771378845,0.6976491855639931,2.6637514357897913,150,411,264,825,0,264,0,0.32,0.49818181818181817
23,16.872983358350275,0.723636732476576,2.762976614910562,194,442,266,902,0,266,0,0.29490022172949004,0.49002217294900224
24,17.650495655662315,0.7456996780181379,2.847216952432889,195,514,274,983,0,274,0,0.2787385554425229,0.5228891149542217
25,18.242625643265704,0.7622853661271735,2.910544125212846,201,567,302,1070,0,302,0,0.2822429906542056,0.5299065420560748
26,18.80556105118397,0.777887659264082,2.9701165171901325,220,617,324,1161,0,324,0,0.27906976744186046,0.5314384151593454
27,19.72070922514853,0.8029238744229586,3.065709338705844,235,661,358,1254,0,358,0,0.28548644338118023,0.5271132376395534
28,20.49542395453127,0.823816759108508,3.1454821711415755,250,736,370,1356,0,370,0,0.2728613569321534,0.5427728613569321
29,21.276059409272296,0.8446046757911864,3.224854216657258,270,800,398,1468,0,398,0,0.27111716621253407,0.5449591280653951
30,22.083042700303395,0.865828665119701,3.3058912668206757,292,879,414,1585,0,414,0,0.261198738170347,0.5545741324921135
31,22.715384392417253,0.882279277262803,3.3687026950034302,333,945,429,1707,0,429,0,0.2513181019332162,0.5536028119507909
32,23.668712179992898,0.9067949736320761,3.4623080811406526,328,1025,481,1834,0,481,0,0.26226826608506,0.5588876772082879
33,24.5745075622461,0.9297850690676062,3.550088445530857,366,1120,473,1959,0,473,0,0.2414497192445125,0.5717202654415519
34,25.414611388163387,0.9508565461331704,3.6305431761448315,394,1215,485,2094,0,485,0,0.23161413562559693,0.5802292263610315
35,26.221014246359765,0.97086536788757,3.706940495570722,424,1310,491,2225,0,491,0,0.22067415730337078,0.5887640449438202
36,27.12432574679251,0.9930367462552572,3.7915948493382543,435,1415,518,2368,0,518,0,0.21875,0.5975506756756757
37,27.94970161828317,1.013080919177323,3.8681271459497792,472,1518,524,2514,0,524,0,0.20843277645186953,0.60381861575179
38,28.69103290047514,1.030916460847249,3.936226486871314,503,1619,540,2662,0,540,0,0.20285499624342598,0.6081893313298272
39,29.493112821456954,1.050041410276069,4.009249021054078,521,1719,576,2816,0,576,0,0.20454545454545456,0.6104403409090909
40,30.275691761720417,1.0685349583303945,4.079860749988778,537,1836,610,2983,0,610,0,0.20449212202480724,0.6154877639959772
41,31.417003576396446,1.095222925876756,4.181760262438522,588,1943,621,3152,0,621,0,0.19701776649746192,0.6164340101522843
42,32.21197662084039,1.113621487090379,4.252009314345084,602,2097,630,3329,0,630,0,0.1892460198257735,0.6299188945629318
43,33.09049789599239,1.1337785066773616,4.328972480040832,653,2200,663,3516,0,663,0,0.1885665529010239,0.6257110352673493
44,33.902474741291975,1.1522506254627447,4.39950238813048,672,2345,671,3688,0,671,0,0.18194143167028198,0.6358459869848156
45,34.70154985231898,1.1702857935842854,4.468363939139998,684,2489,696,3869,0,696,0,0.17989144481778238,0.6433186869992246
46,35.48727604919889,1.1878851733814113,4.535561571092659,752,2590,689,4031,0,689,0,0.1709253287025552,0.6425204663855123
47,36.0292103807437,1.199948244267429,4.581620569021088,765,2740,669,4174,0,669,0,0.16027791087685672,0.6564446574029708
48,36.45424888031268,1.2093670208794634,4.617583170630677,796,2831,663,4290,0,663,0,0.15454545454545454,0.65990675990676
49,36.71808228903777,1.215195107542315,4.639835865161566,831,2915,621,4367,0,621,0,0.14220288527593314,0.6675062972292192
50,37.01443365074748,1.2217248971297328,4.664767789040801,900,2939,588,4427,0,588,0,0.13282132369550487,0.6638807318726
51,37.177398918500465,1.22530823644807,4.67844963007445,903,3006,572,4481,0,572,0,0.12765007810756526,0.6708324034813657
52,37.33600603113819,1.2287907228267068,4.6917463962474235,926,3037,561,4524,0,561,0,0.1240053050397878,0.6713085764809903
53,37.51073110985557,1.2326214029416602,4.70637262941361,942,3085,530,4557,0,530,0,0.1163045863506693,0.6769804696071977
54,37.65665825774858,1.2358161598500146,4.718570792154603,1007,3085,484,4576,0,484,0,0.10576923076923077,0.6741695804195804
55,37.706271949761636,1.2369014030158318,4.7227144478786265,1022,3109,454,4585,0,454,0,0.0990185387131952,0.6780806979280262
56,37.72105838775674,1.237224747467707,4.723949035785791,1023,3109,456,4588,0,456,0,0.0993897122929381,0.677637314734089
57,37.72105838775674,1.2372247474677067,4.72394903578579,1024,3109,455,4588,0,455,0,0.09917175239755885,0.677637314734089
58,37.72105838775673,1.2372247474677067,4.723949035785789,1024,3109,455,4588,0,455,0,0.09917175239755885,0.677637314734089
0,2.325140769936443,0.19305994851394426,0.73713798523506,0,0,25,25,0,6,19,1,0
1,2.7571414268767738,0.21628781217814091,0.8258261919529017,12,0,20,32,0,4,16,0.625,0
2,3.2171220785376184,0.239720060854541,0.9152947778082476,9,9,21,39,0,7,14,0.5384615384615384,0.23076923076923078
3,3.7126871125224894,0.263745415192965,1.0070279489185938,13,12,23,48,0,8,15,0.4791666666666667,0.25
4,4.167146031700349,0.28485149193992204,1.0876147874069748,12,21,24,57,0,10,14,0.42105263157894735,0.3684210526315789
5,4.427830704191383,0.2966106155492967,1.1325132593700418,15,21,32,68,0,16,16,0.47058823529411764,0.3088235294117647
6,4.968984510155229,0.3203104545672506,1.2230035538022295,19,25,43,87,0,24,19,0.4942528735632184,0.28735632183908044
7,5.723716621036123,0.3519746894356786,1.3439033596635002,22,35,51,108,0,30,21,0.4722222222222222,0.32407407407407407
0,2.3251407699364424,0.19305994851394426,0.7371379852350599,0,0,25,25,0,1,24,1,0
1,2.6611215472453447,0.21123659556588106,0.806539728524273,12,0,18,30,0,2,16,0.6,0
2,3.3449060800643005,0.24602654651609604,0.9393740866978213,11,9,15,35,0,4,11,0.42857142857142855,0.2571428571428571
3,3.7997336282723944,0.2678519341787058,1.0227073850459671,11,13,19,43,0,8,11,0.4418604651162791,0.3023255813953488
4,4.239164657878853,0.28812407094146947,1.100110089049247,7,21,22,50,0,12,10,0.44,0.42
5,4.694679035195652,0.30841106833899423,1.1775695336579781,9,25,25,59,0,15,10,0.423728813559322,0.423728813559322
6,5.5148439817530095,0.3433587918397039,1.3110062961152331,13,30,25,68,0,15,10,0.36764705882352944,0.4411764705882353
7,5.854857762658298,0.3573306349259118,1.3643533333534816,14,37,31,82,0,18,13,0.3780487804878049,0.45121951219512196
8,6.330604323132864,0.3764345396496946,1.4372955150261066,14,41,44,99,0,26,18,0.4444444444444444,0.41414141414141414
9,6.957458755132116,0.40089112831483814,1.5306752172021094,19,49,48,116,0,30,18,0.41379310344827586,0.4224137931034483
10,7.7659759240759225,0.4313767277165707,1.6470747785541786,28,57,46,131,0,32,14,0.3511450381679389,0.4351145038167939
11,8.352492009161162,0.45283160560817914,1.7289934032312295,30,69,53,152,0,39,14,0.34868421052631576,0.45394736842105265
12,9.030617210853386,0.4770211565626101,1.8213535068754203,32,79,61,172,0,48,13,0.3546511627906977,0.45930232558139533
13,9.794095082365311,0.5035418398726613,1.922614297695615,35,93,70,198,0,55,15,0.35353535353535354,0.4696969696969697
14,10.344391966405652,0.5222310189606838,1.9939729814862472,40,110,78,228,0,61,17,0.34210526315789475,0.4824561403508772
15,10.98634771178941,0.5436193561785286,2.075637541772564,47,120,90,257,0,71,19,0.35019455252918286,0.4669260700389105
16,11.902066657124626,0.5734218936783977,2.1894290485902452,60,138,85,283,0,68,17,0.3003533568904594,0.4876325088339223
17,12.55795728181796,0.5942994834128829,2.269143482121916,60,165,82,307,0,75,7,0.2671009771986971,0.5374592833876222
18,12.989890241620591,0.6078498858785601,2.3208813824454118,58,184,86,328,0,79,7,0.2621951219512195,0.5609756097560976
19,13.679482758882344,0.6291764655785841,2.402310141300048,61,199,99,359,0,93,6,0.2757660167130919,0.5543175487465181
20,14.375362082071733,0.6503371249786359,2.4831053862820642,68,218,105,391,0,95,10,0.26854219948849106,0.5575447570332481
21,15.126761456358372,0.672806208968389,2.5688964342429395,65,245,119,429,0,112,7,0.2773892773892774,0.5710955710955711
22,15.790933286715987,0.6923588017846574,2.643551788632328,79,264,127,470,0,120,7,0.2702127659574468,0.5617021276595745
23,16.43121560185132,0.7109501464367008,2.714536922758311,85,288,144,517,0,139,5,0.27852998065764023,0.5570599613152805
0,2.3251407699364424,0.1930599485139443,0.7371379852350601,0,0,25,25,0,8,17,1,0
1,2.8196143178235697,0.21954277868666164,0.8382542458945259,13,0,20,33,0,8,12,0.6060606060606061,0
2,3.340931446734858,0.24583161148133092,0.9386297892923544,10,9,22,41,0,12,10,0.5365853658536586,0.21951219512195122
3,3.8797855622400976,0.2716008763289172,1.0370215278013204,11,13,29,53,0,18,11,0.5471698113207547,0.24528301886792453
4,4.256561593403405,0.28891181319916676,1.1031178322150004,13,21,31,65,0,18,13,0.47692307692307695,0.3230769230769231
5,4.781646185925538,0.3122082035045813,1.1920676861084007,17,24,37,78,0,26,11,0.47435897435897434,0.3076923076923077
6,5.32378833757091,0.3353820941581174,1.2805498140582663,16,34,45,95,0,36,9,0.47368421052631576,0.35789473684210527
7,5.852669936742249,0.35724161187847886,1.3640134271723738,16,41,62,119,0,50,12,0.5210084033613446,0.3445378151260504
8,6.585884664365675,0.38648748229352026,1.4756794778479867,29,50,66,145,0,55,11,0.45517241379310347,0.3448275862068966
9,7.4040148437383975,0.4178664841047205,1.5954902120362058,40,61,74,175,0,71,3,0.4228571428571429,0.3485714285714286
10,8.079010776745001,0.4428923138951261,1.6910433803268452,29,88,91,208,0,89,2,0.4375,0.4230769230769231
11,8.707354529687498,0.4655684088260092,1.7776248336993086,48,99,98,245,0,96,2,0.4,0.40408163265306124
12,9.375619976886254,0.48909439100351065,1.867451311104313,52,122,111,285,0,109,2,0.3894736842105263,0.4280701754385965
13,10.067423118179704,0.5128671700397704,1.9582201037882148,67,133,128,328,0,124,4,0.3902439024390244,0.4054878048780488
14,10.702201071798967,0.5342051730869832,2.0396924790593904,80,160,136,376,0,134,2,0.3617021276595745,0.425531914893617
15,11.439760958594674,0.5584753191012571,2.132360309295708,82,191,157,430,0,157,0,0.36511627906976746,0.4441860465116279
16,12.211655685744772,0.5833229349424265,2.2272330243256286,99,220,172,491,0,172,0,0.35030549898167007,0.4480651731160896
17,12.984503871777546,0.6076818408041325,2.320239755797596,108,255,194,557,0,194,0,0.348294434470377,0.4578096947935368
18,13.788334936940222,0.6325097650581313,2.415037284767411,124,299,199,622,0,199,0,0.319935691318328,0.4807073954983923
19,14.488484477402697,0.6537444150598389,2.496115039319385,141,337,216,694,0,216,0,0.3112391930835735,0.48559077809798273
20,15.334895089208759,0.6789637032728514,2.5924068670417966,148,379,244,771,0,244,0,0.3164721141374838,0.4915693904020752
21,16.159045943264772,0.7030774393204622,2.6844774955872195,170,433,251,854,0,251,0,0.2939110070257611,0.5070257611241218
22,16.828795223569745,0.7223727737976862,2.7581505908638935,186,486,271,943,0,271,0,0.2873806998939555,0.5153764581124072
23,17.69282309394628,0.7468913709042203,2.851767052543388,200,538,297,1035,0,297,0,0.28695652173913044,0.5198067632850242
24,18.556460740224804,0.7710030863919946,2.9438299662239786,225,598,300,1123,0,300,0,0.26714158504007124,0.5325022261798753
0,2.325140769936443,0.1930599485139443,0.73713798523506,0,0,25,25,0,6,19,1,0
1,2.7937611211922198,0.2181987197082637,0.8331223843406432,12,0,21,33,0,8,13,0.6363636363636364,0
2,3.23553979294343,0.24063410629168627,0.9187847694773476,9,9,23,41,0,11,12,0.5609756097560976,0.21951219512195122
3,3.8067876442916524,0.2681833342004096,1.0239727305833821,12,13,24,49,0,16,8,0.4897959183673469,0.2653061224489796
4,4.418328898512987,0.2961861269643775,1.130892484773078,11,21,30,62,0,23,7,0.4838709677419355,0.3387096774193548
5,4.981426757354419,0.32084493271876213,1.2250442885625463,14,25,39,78,0,34,5,0.5,0.32051282051282054
6,5.7535230285599726,0.3531955764091298,1.3485649281075862,20,34,43,97,0,37,6,0.44329896907216493,0.35051546391752575
7,6.498994143328031,0.383080561711945,1.4626712356274263,27,43,50,120,0,50,0,0.4166666666666667,0.35833333333333334
8,7.299429455327527,0.41392211357130004,1.5804298881813272,32,56,58,146,0,58,0,0.3972602739726027,0.3835616438356164
9,7.856976776644586,0.4347400638364556,1.6599166073755576,30,74,72,176,0,72,0,0.4090909090909091,0.42045454545454547
10,8.430378948675324,0.4556423499048925,1.739725336000498,38,82,91,211,0,91,0,0.4312796208530806,0.3886255924170616
11,8.989374057005195,0.47556766693805974,1.8158038192180466,43,95,113,251,0,113,0,0.450199203187251,0.3784860557768924
12,9.552981849623418,0.49524335102962336,1.8909291584767434,52,108,147,307,0,147,0,0.4788273615635179,0.3517915309446254
13,10.083452428085282,0.5134114156860682,1.9602981326195321,70,124,168,362,0,168,0,0.46408839779005523,0.3425414364640884
14,10.874863355929275,0.5399355103101341,2.061571948456876,94,142,183,419,0,183,0,0.43675417661097854,0.33890214797136037
15,11.992206838403192,0.5763134547290774,2.200469554420114,96,189,194,479,0,194,0,0.40501043841336115,0.3945720250521921
16,12.764218808047836,0.6007892853783081,2.2939227259899035,119,235,188,542,0,188,0,0.34686346863468637,0.43357933579335795
17,13.616330748603161,0.6272385563576829,2.394910851547516,123,273,220,616,0,220,0,0.35714285714285715,0.4431818181818182
18,14.338790260960671,0.6492336578589875,2.478892148188861,133,318,239,690,0,239,0,0.3463768115942029,0.4608695652173913
19,15.406283023728504,0.6810692404415603,2.6004461907768652,155,369,244,768,0,244,0,0.3177083333333333,0.48046875
20,16.173033823463566,0.7034831210548221,2.6860264622093206,159,437,244,840,0,244,0,0.2904761904761905,0.5202380952380953
21,16.785884728655986,0.7211443015766005,2.753460060565201,179,483,258,920,0,258,0,0.28043478260869564,0.525
0,2.325140769936443,0.19305994851394429,0.7371379852350599,0,0,25,25,0,5,20,1,0
1,2.793761121192219,0.2181987197082637,0.8331223843406432,12,0,21,33,0,7,14,0.6363636363636364,0
2,3.306701723596635,0.24414960893610027,0.9322075977560192,10,9,22,41,0,8,14,0.5365853658536586,0.21951219512195122
3,3.790992570128743,0.26744099170181856,1.0211383319523981,12,13,29,54,0,14,15,0.5370370370370371,0.24074074074074073
4,4.218505064173082,0.2871871927007629,1.0965329175847311,11,21,37,69,0,21,16,0.5362318840579711,0.30434782608695654
5,4.641387138601943,0.30607266722652515,1.1686410930467324,15,25,44,84,0,30,14,0.5238095238095238,0.2976190476190476
6,5.309250687205931,0.3347712648004755,1.2782175565109062,21,34,47,102,0,36,11,0.46078431372549017,0.3333333333333333
7,5.862690133248255,0.35764924469504605,1.3655698433810848,20,44,60,124,0,49,11,0.4838709677419355,0.3548387096774194
8,6.643675279964255,0.3887451198776073,1.484299548623591,32,54,65,151,0,54,11,0.4304635761589404,0.3576158940397351
9,7.259238105737494,0.4124013195971046,1.5746232202798538,37,68,74,179,0,63,11,0.4134078212290503,0.37988826815642457
10,8.142402286721746,0.4452060480178368,1.6998776378862852,45,85,80,210,0,74,6,0.38095238095238093,0.40476190476190477
11,8.91014082946372,0.47276907884613706,1.8051183010488865,51,105,86,242,0,82,4,0.35537190082644626,0.43388429752066116
12,9.639701116986865,0.4982359541083433,1.9023554611409468,46,130,107,283,0,103,4,0.37809187279151946,0.45936395759717313
13,10.402101159076201,0.524171495695429,2.001382074473456,61,152,110,323,0,104,6,0.34055727554179566,0.47058823529411764
14,11.006181313681994,0.5442734217928061,2.0781348832088966,69,172,125,366,0,121,4,0.34153005464480873,0.46994535519125685
15,11.90216190102048,0.5734249528032741,2.1894407288852276,90,192,135,417,0,135,0,0.3237410071942446,0.460431654676259
16,12.460850098572068,0.5912318198233117,2.2574305847799168,93,226,154,473,0,154,0,0.32558139534883723,0.47780126849894294
17,13.292638138750773,0.6172581127451855,2.35680370320889,105,253,168,526,0,168,0,0.3193916349809886,0.48098859315589354
18,13.978717351048543,0.6383186999277589,2.437216854269625,110,295,178,583,0,178,0,0.3053173241852487,0.5060034305317325
19,14.578009435343683,0.6564346588595926,2.506386879282081,123,322,203,648,0,203,0,0.3132716049382716,0.49691358024691357
20,15.208263360849898,0.6752207316858762,2.578115520982435,136,358,220,714,0,220,0,0.3081232492997199,0.5014005602240896
21,15.873701801775786,0.6947760355138942,2.6527812265075976,169,377,240,786,0,240,0,0.3053435114503817,0.4796437659033079
22,16.919039266793906,0.7249529432514806,2.7680021469601983,183,422,259,864,0,259,0,0.29976851851851855,0.48842592592592593
23,17.662799058240935,0.7460461679213284,2.848539913881436,192,498,258,948,0,258,0,0.2721518987341772,0.5253164556962026
24,18.42589221019919,0.7673821672451384,2.9300046385723464,203,541,292,1036,0,292,0,0.28185328185328185,0.5222007722007722
25,19.121564608325304,0.7865777101414696,3.0032967114492473,223,591,318,1132,0,318,0,0.28091872791519434,0.5220848056537103
26,19.584373042706385,0.7992190010334657,3.051563458491414,227,657,341,1225,0,341,0,0.2783673469387755,0.5363265306122449
27,20.586203862984853,0.8262475752279005,3.1547634690519817,260,685,388,1333,0,388,0,0.291072768192048,0.5138784696174044
28,21.40155115765974,0.8479225519682483,3.237522471151494,288,774,368,1430,0,368,0,0.2573426573426573,0.5412587412587413
29,22.120399086777226,0.8668048324722447,3.309618451257662,300,848,401,1549,0,401,0,0.2588766946417043,0.5474499677211104
30,23.007471228749626,0.8898263801994916,3.3975189062162405,349,900,414,1663,0,414,0,0.24894768490679495,0.5411906193625977
31,23.694807019117864,0.9074613476726544,3.4648524183864997,356,997,434,1787,0,434,0,0.24286513710128707,0.5579182988248461
32,24.440070294936913,0.9263909824568405,3.5371292057442987,360,1081,471,1912,0,471,0,0.24633891213389122,0.5653765690376569
33,24.932279272738953,0.938787591013907,3.58446171114401,406,1142,495,2043,0,495,0,0.2422907488986784,0.5589818893783651
34,25.670238118781217,0.9572218790519597,3.654847174562028,399,1214,566,2179,0,566,0,0.25975217989903626,0.55713630105553
35,26.666436886661664,0.9818293532945062,3.748802985306297,443,1293,585,2321,0,585,0,0.2520465316673847,0.5570874623007325
36,27.595180459194513,1.0044959208928539,3.8353480615908944,482,1407,588,2477,0,588,0,0.23738393217601939,0.5680258377069035
37,28.442587007869435,1.0249564560798434,3.913470105032127,502,1521,616,2639,0,616,0,0.23342175066312998,0.5763546798029556
38,29.23486595881514,1.0439028656684526,3.98581094164318,528,1638,632,2798,0,632,0,0.22587562544674766,0.5854181558255898
39,30.09911836061463,1.0643763145351757,4.063982291861583,552,1754,660,2966,0,660,0,0.222521915037087,0.5913688469318948
40,30.91710553125205,1.0835739875347554,4.137282497859977,600,1844,693,3137,0,693,0,0.2209116990755499,0.5878227605992987
41,32.01214444385971,1.109011025242066,4.234405732742436,630,1982,693,3305,0,693,0,0.2096822995461422,0.599697428139183
42,32.86782753920018,1.1286865544250013,4.309530480531823,648,2144,690,3482,0,690,0,0.19816197587593337,0.6157380815623205
43,33.72461438673182,1.1482171083601123,4.384101686465883,670,2274,726,3670,0,726,0,0.19782016348773843,0.6196185286103543
44,34.54721521511556,1.166813330435492,4.455105443480969,714,2416,719,3849,0,719,0,0.18680176669264745,0.6276955053260587
45,35.29534775587152,1.1835982889379009,4.519193466853799,763,2536,718,4017,0,718,0,0.17874035349763506,0.6313169031615633
46,35.91573085104984,1.1974273056108824,4.5719951668779135,778,2671,709,4158,0,709,0,0.1705146705146705,0.6423761423761424
47,36.28946783212329,1.2057198703483816,4.6036576867847305,802,2786,682,4270,0,682,0,0.15971896955503512,0.6524590163934426
48,36.64114069818662,1.2134969119315127,4.633351845556685,822,2866,668,4356,0,668,0,0.15335169880624427,0.6579430670339761
49,36.94540527212923,1.220205491237258,4.658966421087713,897,2906,608,4411,0,608,0,0.13783722511902063,0.6588075266379506
50,37.150022019148054,1.2247066297440876,4.676152586295608,885,2991,586,4462,0,586,0,0.131331241595697,0.6703272075302555
51,37.303596738909384,1.2280795237169078,4.689030908737285,917,3024,556,4497,0,556,0,0.12363798087613966,0.6724482988659106
52,37.4089739787652,1.2303912003385498,4.697857310383553,930,3066,527,4523,0,527,0,0.1165155869997789,0.6778686712359053
53,37.48709874703588,1.2321036343829779,4.7043956949168235,953,3082,507,4542,0,507,0,0.11162483487450463,0.6785557023337737
54,37.56929394179865,1.2339040053306267,4.711269838535122,994,3083,479,4556,0,479,0,0.10513608428446006,0.6766900790166813
55,37.60392498696079,1.2346621568002105,4.714164598691716,982,3107,478,4567,0,478,0,0.10466389314648566,0.6803153054521568
56,37.64635120454871,1.235590644989574,4.717709735414739,1004,3107,463,4574,0,463,0,0.10122431132487976,0.6792741582859642
57,37.676138451556945,1.2362423237614963,4.720197963452983,1029,3107,442,4578,0,442,0,0.09654871122761031,0.6786806465705548
58,37.680605197575495,1.2363400314282795,4.7205710290897995,1029,3107,443,4579,0,443,0,0.09674601441362743,0.6785324306617165
59,37.6806051975755,1.2363400314282809,4.720571029089798,1029,3107,443,4579,0,443,0,0.09674601441362743,0.6785324306617165
60,37.680605197575524,1.2363400314282809,4.7205710290897995,1029,3107,443,4579,0,443,0,0.09674601441362743,0.6785324306617165
61,37.68060519757547,1.2363400314282806,4.7205710290897995,1029,3107,443,4579,0,443,0,0.09674601441362743,0.6785324306617165
62,37.68060519757552,1.2363400314282804,4.720571029089799,1029,3107,443,4579,0,443,0,0.09674601441362743,0.6785324306617165
63,37.68060519757545,1.2363400314282806,4.7205710290897995,1029,3107,443,4579,0,443,0,0.09674601441362743,0.6785324306617165
64,37.68060519757549,1.2363400314282804,4.720571029089798,1029,3107,443,4579,0,443,0,0.09674601441362743,0.6785324306617165
65,37.68060519757547,1.2363400314282809,4.720571029089799,1029,3107,443,4579,0,443,0,0.09674601441362743,0.6785324306617165
66,37.68060519757548,1.2363400314282804,4.720571029089797,1029,3107,443,4579,0,443,0,0.09674601441362743,0.6785324306617165
67,37.681000620730785,1.2363486809111053,4.720604054387857,1031,3107,441,4579,0,441,0,0.09630923782485258,0.6785324306617165
