Iteration, Rt, Rn, delta p, delta n, nNT, nNe, nPT, nT, nI, nonmut, mut , GF , NF 
0,2.325140769936442,1.3949428361874383,0.1930599485139443,0.7371379852350599,0,0,25,25,0,6,19,1,0
1,2.73376493352434,1.6975496778581107,0.2150635436288402,0.8211517120373899,11,0,22,33,0,8,14,0.6666666666666666,0
2,3.3276622014182595,2.146339113300664,0.24518026357157624,0.9361428245460182,10,9,24,43,0,12,12,0.5581395348837209,0.20930232558139536
3,3.8444034979003083,2.543749304669146,0.2699470967083546,1.0307070965228085,13,12,32,57,0,17,15,0.5614035087719298,0.21052631578947367
4,4.360813509393148,2.946146542911444,0.2936101251188443,1.12105684136286,11,21,43,75,0,26,17,0.5733333333333334,0.28
5,4.938872011988625,3.4017994003605114,0.31901507033791043,1.2180575412902035,19,25,49,93,0,32,17,0.5268817204301075,0.26881720430107525
6,5.61754105790783,3.942700870508954,0.34760834078089864,1.3272318466179767,23,37,55,115,0,38,17,0.4782608695652174,0.3217391304347826
7,6.28344085843477,4.478730307290225,0.37456256721867925,1.430147983925866,37,44,52,133,0,43,9,0.39097744360902253,0.3308270676691729
8,6.92089002808007,4.9960978939229905,0.399485159919394,1.5253069742376864,27,67,68,162,0,55,13,0.41975308641975306,0.41358024691358025
9,7.627856039799089,5.574122030575185,0.4262466811596783,1.6274873280642264,54,67,67,188,0,57,10,0.35638297872340424,0.35638297872340424
10,8.317112693285342,6.141453195551676,0.4515519712277415,1.724107526505922,53,92,66,211,0,59,7,0.3127962085308057,0.43601895734597157
11,8.882782128059105,6.609559992546315,0.471800820578126,1.8014213149346623,48,115,74,237,0,66,8,0.31223628691983124,0.48523206751054854
12,9.550301419422123,7.164575281397864,0.4951507078918266,1.890575430132428,57,128,84,269,0,77,7,0.31226765799256506,0.4758364312267658
13,10.178772389986651,7.6894978053798315,0.5166418949183965,1.9726326896884236,59,147,98,304,0,91,7,0.3223684210526316,0.48355263157894735
14,10.783958836448788,8.196969229945324,0.5369223711610954,2.0500672353423646,70,166,109,345,0,103,6,0.3159420289855073,0.4811594202898551
15,11.421601058051326,8.733613871746241,0.5578841330067145,2.130103053298365,81,186,125,392,0,117,8,0.31887755102040816,0.4744897959183674
16,12.21906749080052,9.407374411023413,0.5835589410858151,2.2281341386912925,96,205,141,442,0,133,8,0.3190045248868778,0.4638009049773756
17,13.02924399812722,10.09460051874209,0.6090769485516297,2.3255665308334956,111,236,149,496,0,142,7,0.3004032258064516,0.47580645161290325
18,13.785361183722431,10.738252329355984,0.6324188188307738,2.4146900355356817,115,276,165,556,0,160,5,0.29676258992805754,0.49640287769784175
19,14.656946404131947,11.482717786317792,0.65880216596143,2.5154264518527327,141,304,165,610,0,163,2,0.27049180327868855,0.49836065573770494
20,15.281087986359287,12.017374291462767,0.6773745404502206,2.5863391544462964,128,358,189,675,0,185,4,0.28,0.5303703703703704
21,15.978518501091454,12.616241090269439,0.6978311607366453,2.6644462500853745,170,373,199,742,0,197,2,0.26819407008086255,0.5026954177897575
22,16.66472089364596,13.206856965532964,0.7176698718725059,2.7401940562404765,183,418,212,813,0,212,0,0.2607626076260763,0.5141451414514145
23,17.302204895298402,13.756710226116606,0.7358573841698057,2.8096372850119855,182,465,239,886,0,239,0,0.2697516930022573,0.5248306997742663
24,18.194895118230946,14.52847488757579,0.7609551422114474,2.905465088443707,215,500,247,962,0,247,0,0.25675675675675674,0.5197505197505198
25,18.883700950495733,15.125321608134836,0.7800409955843407,2.9783383467765736,215,565,271,1051,0,271,0,0.25784966698382494,0.5375832540437678
26,19.42473270605405,15.59490499495822,0.7948699023029087,3.0349578087929237,244,609,289,1142,0,289,0,0.2530647985989492,0.5332749562171629
27,19.830074008827975,15.947151176444128,0.8058896444570188,3.077033187926798,261,645,337,1243,0,337,0,0.2711182622687047,0.5189058728881738
28,20.49816548060657,16.528512595120528,0.8238902215159697,3.1457626639700664,278,674,400,1352,0,400,0,0.2958579881656805,0.4985207100591716
29,21.173101153375693,17.116781380750986,0.8418776886579536,3.21444208396673,292,740,425,1457,0,425,0,0.2916952642415923,0.5078929306794784
30,21.680633180684147,17.55974803215836,0.8552780496940325,3.2656070988317594,318,806,447,1571,0,447,0,0.28453214513049013,0.513049013367282
31,22.445704626679625,18.228435026878437,0.8752823697700601,3.3419872300311373,332,857,498,1687,0,498,0,0.2951985773562537,0.5080023710729105
32,23.150429526752287,18.845342797469197,0.8935085664549762,3.4115781628280897,363,929,524,1816,0,524,0,0.28854625550660795,0.5115638766519823
33,24.15474815677528,19.72603507063802,0.919166866934146,3.5095462192031035,395,1004,543,1942,0,543,0,0.2796086508753862,0.5169927909371782
34,24.831143200341707,20.32013434896918,0.9362471200961826,3.5747617312763325,403,1120,551,2074,0,551,0,0.2656702025072324,0.5400192864030858
35,25.84335405834246,21.210572875310007,0.9615206228935282,3.6712605601389248,424,1206,575,2205,0,575,0,0.26077097505668934,0.5469387755102041
36,26.867803701792454,22.113386221111433,0.9867658922168151,3.7676515884642012,457,1321,577,2355,0,577,0,0.24501061571125266,0.5609341825902335
37,27.517877980680378,22.68707680502643,1.0026191119281733,3.8281820637257558,474,1448,584,2506,0,584,0,0.23304070231444532,0.5778132482043097
38,28.421009513918804,23.485080905306695,1.024438013108178,3.9114905955039543,522,1528,609,2659,0,609,0,0.22903347122978562,0.5746521248589695
39,29.518220472760454,24.45605911391443,1.0506372631567158,4.011524095689274,538,1657,621,2816,0,621,0,0.22052556818181818,0.5884232954545454
40,30.54115173127481,25.36270543522528,1.0747718727649935,4.103674423284519,583,1804,593,2980,0,593,0,0.19899328859060403,0.6053691275167785
0,2.3251407699364424,1.3949428361874385,0.19305994851394429,0.7371379852350599,0,0,25,25,0,4,21,1,0
1,2.744794055666126,1.7057936608050954,0.21564159138625152,0.8233588034747784,10,0,22,32,0,6,16,0.6875,0
2,3.3643356740375774,2.174349040050334,0.2469783579973524,0.9430082759898909,10,9,20,39,0,8,12,0.5128205128205128,0.23076923076923078
3,3.691829505706922,2.4258200174644005,0.2627566862390142,1.003252802003509,9,13,29,51,0,14,15,0.5686274509803921,0.2549019607843137
4,4.239264671458476,2.8510086767065967,0.28812860268435253,1.1001273920675279,7,21,40,68,0,23,17,0.5882352941176471,0.3088235294117647
5,4.845036459374881,3.327494984634799,0.3149614381536021,1.2025800365864805,14,25,49,88,0,32,17,0.5568181818181818,0.2840909090909091
6,5.507585646314865,3.8546724667437533,0.34305745236381574,1.3098557272072966,23,32,55,110,0,38,17,0.5,0.2909090909090909
7,6.208989962398984,4.418563417441748,0.37159796216093616,1.4188285827963019,31,42,59,132,0,44,15,0.44696969696969696,0.3181818181818182
8,6.789629300032137,4.889251660079912,0.3944180007448011,1.5059596392074224,35,56,69,160,0,59,10,0.43125,0.35
9,7.514250673862487,5.480959124987855,0.4220039063702069,1.611287642504426,43,64,86,193,0,74,12,0.44559585492227977,0.3316062176165803
10,8.1580935583951,6.01025488789148,0.4457778372743373,1.7020608332292877,46,90,93,229,0,77,16,0.40611353711790393,0.3930131004366812
11,8.997196438423975,6.704495873208506,0.47584351353528703,1.8168570516801872,55,109,99,263,0,87,12,0.376425855513308,0.4144486692015209
12,9.990756207368523,7.532230367135408,0.5102600800483831,1.9482657601847353,71,130,98,299,0,92,6,0.3277591973244147,0.43478260869565216
13,10.433780927955427,7.903102213958009,0.5252352047919161,2.0054435092054983,62,169,109,340,0,97,12,0.3205882352941177,0.4970588235294118
14,11.15240690470003,8.50682258808659,0.5490835374103364,2.096500779203103,75,182,130,387,0,122,8,0.3359173126614987,0.4702842377260982
15,11.75654310654391,9.016258759289805,0.568738260750852,2.1715460865032523,84,208,140,432,0,128,12,0.32407407407407407,0.48148148148148145
16,12.432517954064865,9.58817517611516,0.5903352935367322,2.2540074844129774,104,232,145,481,0,136,9,0.30145530145530147,0.48232848232848236
17,13.09710866820717,10.15228367613716,0.6111900926937742,2.333634899376228,105,265,167,537,0,160,7,0.31098696461824954,0.4934823091247672
18,13.798983241872795,10.749867376328764,0.6328353683204605,2.416280497223577,119,294,189,602,0,185,4,0.313953488372093,0.4883720930232558
19,14.618776392013439,11.450061109678384,0.6576578887865234,2.5110573935485436,144,324,202,670,0,198,4,0.30149253731343284,0.4835820895522388
20,15.239155354795916,11.9814150029543,0.6761347900048644,2.581605561836755,142,380,211,733,0,208,3,0.2878581173260573,0.5184174624829468
21,15.992929473692808,12.628630748767524,0.6982506787580798,2.6660480461672136,177,401,224,802,0,220,4,0.2793017456359102,0.5
22,16.75130487653402,13.281474072566876,0.7201535630875194,2.7496772408796186,186,456,231,873,0,229,2,0.2646048109965636,0.5223367697594502
23,17.286636409644892,13.743268878377044,0.7354159027159719,2.807951628551892,186,506,265,957,0,261,4,0.2769070010449321,0.5287356321839081
24,18.182176359966697,14.517464951003326,0.7606004811056044,2.9041109278577615,214,544,291,1049,0,288,3,0.27740705433746427,0.5185891325071497
25,18.952512075212198,15.185008056174919,0.7819347964039643,2.985569222633318,226,611,305,1142,0,303,2,0.2670753064798599,0.5350262697022767
26,19.665600346609434,15.804177673894072,0.8014273471673408,3.059995325548029,257,667,314,1238,0,310,4,0.25363489499192243,0.5387722132471728
27,20.481521471278317,16.51401771743946,0.8234441753250434,3.1440595785138026,277,719,346,1342,0,342,4,0.2578241430700447,0.5357675111773472
28,21.084471232436808,17.03947912135903,0.8395266645633116,3.2054654465144616,293,796,357,1446,0,355,2,0.24688796680497926,0.5504840940525588
29,21.73414440218864,17.606481376986324,0.8566847788155734,3.2709782463867327,319,852,383,1554,0,379,4,0.24646074646074645,0.5482625482625483
30,22.493483579062488,18.27023138531036,0.8765240402127048,3.346728153539419,335,910,424,1669,0,422,2,0.25404433792690234,0.5452366686638705
31,23.128987230727386,18.82655920517168,0.8929567600209989,3.409471265534719,364,987,439,1790,0,435,4,0.24525139664804468,0.5513966480446927
32,24.011083534936834,19.599948269953007,0.9155186399023055,3.495616625081532,402,1049,465,1916,0,465,0,0.24269311064718163,0.5474947807933194
33,24.943607951546106,20.418988576529095,0.9390719457582432,3.585547429258745,424,1152,461,2037,0,461,0,0.226313205694649,0.5655375552282769
34,25.836497835727062,21.204536071197836,0.9613505549022903,3.670611209626925,413,1272,483,2168,0,483,0,0.2227859778597786,0.5867158671586716
35,26.75306280648635,22.012191033970844,0.983954518823974,3.756917253691538,444,1369,499,2312,0,499,0,0.21583044982698962,0.592128027681661
36,27.5350265510941,22.702218613814406,1.0030356096240867,3.8297723276556024,490,1468,499,2457,0,499,0,0.20309320309320308,0.5974765974765974
37,28.28959236950902,23.368891148027274,1.0212776120056406,3.8994236094760852,513,1573,526,2612,0,526,0,0.20137825421133232,0.6022205206738132
38,29.14758154075562,24.12788395607971,1.041824027008205,3.977873557667694,532,1678,554,2764,0,554,0,0.20043415340086831,0.6070911722141823
39,30.13228657981183,25.00016114553761,1.065158109000309,4.0669673252739065,576,1782,562,2920,0,562,0,0.19246575342465752,0.6102739726027397
40,30.933659656837,25.710939715347628,1.083960742573262,4.138759198916091,589,1921,563,3073,0,563,0,0.18320859095346567,0.625122030589001
41,31.795926735367843,26.476597623745874,1.1040117024121128,4.2153174092098835,620,2043,577,3240,0,577,0,0.17808641975308642,0.6305555555555555
42,32.552268409176484,27.148914986416948,1.1214507103840554,4.2819027123754845,649,2169,596,3414,0,596,0,0.17457527826596367,0.6353251318101933
43,33.29856228482586,27.812936329507192,1.1385261416699075,4.347099813648736,705,2265,621,3591,0,621,0,0.17293233082706766,0.6307435254803676
44,34.22787888664577,28.64065774973734,1.1596119340753266,4.427609202833065,723,2380,666,3769,0,666,0,0.17670469620589016,0.6314672326877155
45,35.00996070458656,29.337951175384752,1.1772095249286847,4.494800004273158,742,2532,682,3956,0,682,0,0.1723963599595551,0.6400404448938322
46,35.829926394454546,30.069696541677494,1.1955194034065635,4.564710449370513,776,2657,691,4124,0,691,0,0.16755577109602326,0.6442774005819593
47,36.36803898608742,30.55027910808645,1.2074595973209605,4.610300280680031,816,2792,654,4262,0,654,0,0.15344908493664947,0.655091506335054
48,36.73945061658108,30.8821482818314,1.2156665223065424,4.641635812443158,847,2891,625,4363,0,625,0,0.1432500573000229,0.662617465046986
49,37.01858346504395,31.131650817257157,1.2218162099180094,4.665116437868759,912,2942,580,4434,0,580,0,0.13080739738385205,0.663509246729815
50,37.217241536989846,31.309266427641134,1.2261835132610548,4.681791596087666,909,2998,583,4490,0,583,0,0.12984409799554567,0.6677060133630289
51,37.39312102772843,31.46654746042871,1.2300435705716433,4.696529996728092,922,3036,570,4528,0,570,0,0.12588339222614842,0.6704946996466431
52,37.51431256350964,31.574940507892016,1.2326998605998771,4.706672195017712,963,3076,512,4551,0,512,0,0.11250274664908812,0.6758954076027247
53,37.609530820661135,31.66011286261073,1.2347848592180104,4.714633098832403,1003,3076,490,4569,0,490,0,0.10724447362661414,0.673232654847888
54,37.67478436361383,31.718486794356878,1.2362127030533312,4.720084866203629,1002,3100,477,4579,0,477,0,0.10417121642279974,0.6770037126010046
55,37.708217931796185,31.748397036222986,1.236943959458586,4.7228769361145995,1029,3100,452,4581,0,452,0,0.09866841301025976,0.6767081423270028
56,37.70821793179618,31.748397036222993,1.2369439594585852,4.722876936114602,1029,3100,452,4581,0,452,0,0.09866841301025976,0.6767081423270028
57,37.70821793179617,31.748397036222983,1.2369439594585854,4.7228769361145995,1029,3100,452,4581,0,452,0,0.09866841301025976,0.6767081423270028
58,37.7082179317962,31.748397036222997,1.2369439594585858,4.722876936114601,1029,3100,452,4581,0,452,0,0.09866841301025976,0.6767081423270028
59,37.70821793179614,31.74839703622297,1.2369439594585854,4.7228769361146,1029,3100,452,4581,0,452,0,0.09866841301025976,0.6767081423270028
60,37.70871693575109,31.748843461583547,1.2369548719970234,4.722918602170455,1031,3100,450,4581,0,450,0,0.09823182711198428,0.6767081423270028
61,37.70573297735509,31.746173917651852,1.2368896161648293,4.7226694435384395,1037,3100,444,4581,0,442,2,0.09692206941715782,0.6767081423270028
62,37.71258434094808,31.752303377415657,1.2370394452614528,4.723241518270999,1071,3100,410,4581,0,405,5,0.08950010914647456,0.6767081423270028
63,37.693131639721685,31.73490045235257,1.2366140200200102,4.7216171673491285,1120,3100,361,4581,0,328,33,0.07880375463872517,0.6767081423270028
64,37.70692580468646,31.747241057863725,1.2369157021707595,4.72276904465199,1157,3100,324,4581,0,252,72,0.07072691552062868,0.6767081423270028
65,37.70082794640157,31.741785739232657,1.2367823448841098,4.722259862284784,1186,3100,295,4581,0,192,103,0.06439641999563414,0.6767081423270028
66,37.7138315210067,31.753419151247932,1.237066718251822,4.723345651506959,1201,3100,280,4581,0,156,124,0.061122025758568,0.6767081423270028
67,37.687890189353276,31.73021136604477,1.2364993784225145,4.721179444885963,1225,3100,256,4581,0,122,134,0.05588299497926217,0.6767081423270028
68,37.72135140096268,31.760146747236043,1.2372311545470391,4.723973499179603,1235,3100,246,4581,0,87,159,0.053700065487884745,0.6767081423270028
69,37.709697941567356,31.74972110234856,1.2369763251208836,4.7230005140979205,1238,3100,243,4581,0,84,159,0.05304518664047151,0.6767081423270028
70,37.71189587531454,31.751687450982953,1.2370243899556166,4.723184034375991,1253,3100,228,4581,0,72,156,0.04977079240340537,0.6767081423270028
71,37.70555824677901,31.746017598387255,1.2368857949492382,4.722654853442544,1253,3100,228,4581,0,43,185,0.04977079240340537,0.6767081423270028
72,37.71082072515509,31.75072558337159,1.2370008784833717,4.723094263300148,1257,3100,224,4581,0,46,178,0.048897620606854396,0.6767081423270028
73,37.70555824677901,31.746017598387255,1.2368857949492376,4.722654853442545,1253,3100,228,4581,0,53,175,0.04977079240340537,0.6767081423270028
74,37.710820725155095,31.75072558337159,1.2370008784833717,4.723094263300145,1257,3100,224,4581,0,43,181,0.048897620606854396,0.6767081423270028
75,37.70555824677904,31.746017598387244,1.2368857949492378,4.722654853442544,1253,3100,228,4581,0,40,188,0.04977079240340537,0.6767081423270028
76,37.710820725155074,31.750725583371562,1.237000878483371,4.723094263300147,1257,3100,224,4581,0,48,176,0.048897620606854396,0.6767081423270028
77,37.70555824677904,31.74601759838726,1.2368857949492382,4.722654853442545,1253,3100,228,4581,0,42,186,0.04977079240340537,0.6767081423270028
78,37.71082072515511,31.750725583371576,1.237000878483372,4.723094263300147,1257,3100,224,4581,0,45,179,0.048897620606854396,0.6767081423270028
79,37.70555824677906,31.74601759838726,1.2368857949492382,4.722654853442544,1253,3100,228,4581,0,51,177,0.04977079240340537,0.6767081423270028
80,37.71082072515508,31.750725583371583,1.2370008784833713,4.723094263300147,1257,3100,224,4581,0,47,177,0.048897620606854396,0.6767081423270028
81,37.70555824677903,31.746017598387237,1.2368857949492376,4.722654853442545,1253,3100,228,4581,0,47,181,0.04977079240340537,0.6767081423270028
82,37.710820725155095,31.750725583371583,1.2370008784833715,4.723094263300147,1257,3100,224,4581,0,46,178,0.048897620606854396,0.6767081423270028
83,37.70555824677903,31.746017598387276,1.236885794949238,4.722654853442544,1253,3100,228,4581,0,55,173,0.04977079240340537,0.6767081423270028
84,37.7108207251551,31.75072558337157,1.2370008784833717,4.723094263300148,1257,3100,224,4581,0,44,180,0.048897620606854396,0.6767081423270028
85,37.70555824677903,31.746017598387258,1.236885794949238,4.722654853442545,1253,3100,228,4581,0,53,175,0.04977079240340537,0.6767081423270028
86,37.71082072515508,31.75072558337157,1.2370008784833717,4.723094263300145,1257,3100,224,4581,0,39,185,0.048897620606854396,0.6767081423270028
0,2.325140769936443,1.3949428361874385,0.1930599485139443,0.73713798523506,0,0,25,25,0,1,24,1,0
1,2.608823927652255,1.60442621350011,0.20845990293723768,0.7959378112149074,13,0,15,28,0,0,15,0.5357142857142857,0
2,3.0433956163360283,1.9303452675106951,0.23101044975620114,0.8820398990691316,10,9,13,32,0,0,13,0.40625,0.28125
3,3.381408230195433,2.187399213257174,0.24781319219473305,0.9461958247435261,12,9,17,38,0,0,17,0.4473684210526316,0.23684210526315788
4,3.6095134738431405,2.3623932715716793,0.25883626839596363,0.9882839338754975,12,13,17,42,0,0,17,0.40476190476190477,0.30952380952380953
5,4.088525715982833,2.733376789431353,0.28125732437860923,1.0738916021728715,8,21,22,51,0,0,22,0.43137254901960786,0.4117647058823529
6,4.576970090708465,3.1159329621846066,0.30323412101438557,1.1578030075094718,15,21,21,57,0,0,21,0.3684210526315789,0.3684210526315789
7,4.917294154173921,3.3847017736629206,0.3180852110494527,1.2145071694615466,14,28,23,65,0,0,23,0.35384615384615387,0.4307692307692308
8,5.380218013576249,3.752887432913673,0.33774785636393095,1.289582724298645,15,34,21,70,0,0,21,0.3,0.4857142857142857
9,5.558974632998089,3.89579561387504,0.3451880983085571,1.3179909208144909,15,38,27,80,0,0,27,0.3375,0.475
10,5.642547527373217,3.962740655788293,0.3486391620270598,1.331167709557865,21,38,31,90,0,0,31,0.34444444444444444,0.4222222222222222
11,5.691270234167363,4.0018072748550075,0.35064325570633803,1.338819703606018,24,38,34,96,0,0,34,0.3541666666666667,0.3958333333333333
12,6.252032445455014,4.453340934248239,0.37331333251461396,1.4253781786921624,26,41,45,112,0,0,45,0.4017857142857143,0.36607142857142855
13,6.870867410974028,4.9553611248454565,0.39755790844177835,1.51794837768679,29,51,46,126,0,0,46,0.36507936507936506,0.40476190476190477
14,7.167621100493587,5.197350414887955,0.40892410455965944,1.5613465810459726,31,59,52,142,0,0,52,0.36619718309859156,0.4154929577464789
15,7.874665932187284,5.776866506941987,0.43539233354147727,1.6624070917038223,34,73,53,160,0,0,53,0.33125,0.45625
16,8.378285401490224,6.191970894719391,0.45376338819772083,1.7325511185731162,38,81,64,183,0,0,64,0.34972677595628415,0.4426229508196721
17,8.747586980066119,6.497489244465783,0.4670014168227117,1.7830963187776263,41,95,62,198,0,0,62,0.31313131313131315,0.4797979797979798
18,9.453147448411631,7.083628654909848,0.49178691940603014,1.8777318740957518,50,105,62,217,0,0,62,0.2857142857142857,0.4838709677419355
19,10.075666209075568,7.603230253923211,0.51314708503162,1.959288870120731,51,122,64,237,0,0,64,0.270042194092827,0.5147679324894515
20,10.481921882688376,7.943464857317852,0.5268495713033169,2.01160745406721,57,134,67,258,0,0,67,0.2596899224806202,0.5193798449612403
21,10.8735440323259,8.27224698537343,0.5398918399335316,2.0614052070189386,60,145,81,286,0,0,81,0.28321678321678323,0.506993006993007
22,11.479394999985708,8.782347866329541,0.5597644994380728,2.1372826342180957,66,163,86,315,0,0,86,0.273015873015873,0.5174603174603175
23,12.0431387475668,9.25849913944649,0.5779440696098758,2.2066955385104334,71,178,98,347,0,0,98,0.2824207492795389,0.5129682997118156
24,12.48599440909063,9.633501148437004,0.5920269031545247,2.2604663574990935,73,201,109,383,0,0,109,0.2845953002610966,0.5248041775456919
25,13.06443653811281,10.124511037202948,0.610173217169971,2.3297522837398894,86,214,114,414,0,0,114,0.2753623188405797,0.5169082125603864
26,13.562886428153314,10.548650192963187,0.6255961997564427,2.3886400354336894,89,237,129,455,0,0,129,0.2835164835164835,0.5208791208791209
27,14.109123353014157,11.01448984824047,0.6422824255190667,2.452351079254618,101,254,136,491,0,0,136,0.2769857433808554,0.5173116089613035
28,14.493464436085917,11.342883246616633,0.6538942091351355,2.4966869803341534,115,274,145,534,0,0,145,0.27153558052434457,0.5131086142322098
29,15.382685118386199,12.104521422400655,0.6803735972800197,2.597790098705529,119,293,160,572,0,0,160,0.27972027972027974,0.5122377622377622
30,16.01383043590929,12.6466011754015,0.6988589031242587,2.6683703573835316,117,342,153,612,0,0,153,0.25,0.5588235294117647
31,16.6351562931084,13.181383267278838,0.7168208166816068,2.7369522091479523,135,365,155,655,0,0,155,0.2366412213740458,0.5572519083969466
32,17.36135038334328,13.807780414986354,0.7375333896589847,2.816036578697943,142,399,153,694,0,0,153,0.22046109510086456,0.5749279538904899
33,17.909507437680467,14.281526771053707,0.752977119488572,2.8750035471381836,149,429,167,745,0,0,167,0.22416107382550335,0.5758389261744966
34,18.437892137659556,14.73890021521211,0.7677153046589045,2.9312766177885456,154,459,174,787,0,0,174,0.22109275730622618,0.5832274459974587
35,19.23168411337613,15.427273240203865,0.7895947095263188,3.014816163645945,162,482,193,837,0,0,193,0.23058542413381122,0.5758661887694145
36,19.78587864715505,15.908727216520834,0.8046918063580476,3.0724596242761817,169,531,195,895,0,0,195,0.21787709497206703,0.5932960893854748
37,20.227369904246725,16.292755773479815,0.8166180271403036,3.1179961036266124,177,559,218,954,0,0,218,0.22851153039832284,0.5859538784067087
38,20.752004296308254,16.749646577002615,0.8306780172143784,3.171679702091262,188,587,246,1021,0,0,246,0.24094025465230168,0.574926542605289
39,21.218239975122586,17.156157151288852,0.8430737936258665,3.2190090302078542,203,609,277,1089,0,0,277,0.25436179981634527,0.559228650137741
40,21.609670171643053,17.497781998007984,0.8534107530185996,3.258477420616472,214,644,306,1164,0,0,306,0.26288659793814434,0.5532646048109966
41,22.689784254882767,18.441996774728977,0.8816162694658751,3.3661712106878867,236,673,322,1231,0,0,322,0.26157595450852966,0.5467099918765231
42,23.518251247006653,19.167683992590458,0.9029479207278885,3.447619333688301,240,755,306,1301,0,0,306,0.23520368946963874,0.5803228285933897
43,24.145025218111687,19.717500662824,0.918920190720088,3.5086043645676064,268,801,310,1379,0,0,310,0.22480058013052936,0.5808556925308195
44,24.728532128976795,20.229959242427654,0.9336660707932214,3.5649068157559367,277,849,341,1467,0,0,341,0.23244717109747784,0.5787321063394683
45,25.66491272925248,21.053481558658873,0.9570894882364139,3.6543416823572175,302,897,360,1559,0,0,360,0.23091725465041693,0.5753688261706222
46,26.238959261512814,21.55901939147904,0.9713082749126741,3.7086315951211195,320,971,360,1651,0,0,360,0.2180496668685645,0.5881284070260449
47,26.966470274116865,22.200420148522852,0.9891802147459268,3.7768699108480854,334,1025,394,1753,0,0,394,0.22475755847119225,0.5847119224187107
48,27.861355692577487,22.990439027615793,1.0109449681995977,3.859971696762099,357,1083,411,1851,0,0,411,0.22204213938411668,0.5850891410048622
49,28.544649553390418,23.594416109752032,1.0274069411324933,3.9228265025058837,375,1163,416,1954,0,0,416,0.2128966223132037,0.5951893551688844
50,29.472432132027148,24.415507040392313,1.0495504907166637,4.007374600918169,400,1235,434,2069,0,0,434,0.2097631706138231,0.596906718221363
51,30.360152698454,25.202186355100743,1.0705213165450134,4.087445026808231,392,1341,456,2189,0,0,456,0.20831429876656007,0.6126084970306076
52,31.522870118990156,26.23403893715948,1.097681943398819,4.191149238431855,438,1424,442,2304,0,0,442,0.1918402777777778,0.6180555555555556
53,32.00098617878195,26.658811172970516,1.1087533030929373,4.233421702718486,444,1540,455,2439,0,0,455,0.18655186551865519,0.6314063140631406
54,32.6907547427506,27.272087261108183,1.1246290999635205,4.294038381678894,465,1591,513,2569,0,0,513,0.19968859478396264,0.6193071233943168
55,33.41889195837724,27.920058492595498,1.1412673230867807,4.3575661426949805,491,1669,539,2699,0,0,539,0.19970359392367543,0.618377176732123
56,34.311374332742844,28.715070579061916,1.1614970054809448,4.434806748199973,523,1756,550,2829,0,0,550,0.19441498762813716,0.6207140332272888
57,35.14458436350541,29.458043767031995,1.1802254068152376,4.506315189658177,541,1867,548,2956,0,0,548,0.18538565629228687,0.631596752368065
58,35.708085503164334,29.960921635153873,1.1928075952474555,4.554356272763008,554,1972,549,3075,0,0,549,0.17853658536585365,0.6413008130081301
59,36.134184287372435,30.341390886696313,1.2022778756120163,4.59051552506406,607,2034,526,3167,0,0,526,0.1660877802336596,0.6422481844016419
60,36.32101466204769,30.50827082236796,1.2064185327637182,4.606325306916015,629,2095,513,3237,0,0,513,0.15848007414272475,0.6472042014210689
61,36.396217206536235,30.575452621423203,1.2080832157781796,4.612681369334868,649,2130,519,3298,0,0,519,0.15736810187992722,0.6458459672528806
62,36.52244897592381,30.688233517881258,1.2108749063861768,4.623340551656309,675,2142,525,3342,0,0,525,0.1570915619389587,0.6409335727109515
63,36.6328717080581,30.786902642129547,1.2133143344379977,4.632654731490538,684,2170,533,3387,0,0,533,0.1573664009447889,0.6406849719515796
64,36.68673089698634,30.835033241134923,1.2145032870634926,4.637194368787881,725,2179,527,3431,0,0,527,0.15359953366365492,0.6350918099679393
65,36.818360792939146,30.95267445579313,1.2174065982755895,4.648279738870433,749,2198,523,3470,0,0,523,0.15072046109510087,0.6334293948126801
66,36.747857076302154,30.88966129145533,1.2158519553455673,4.642343829501255,760,2218,525,3503,0,0,525,0.14987153868113046,0.6331715672280902
67,36.713514354419814,30.858968990832377,1.2150943207445652,4.639451042842884,770,2225,542,3537,0,0,542,0.15323720667232119,0.6290641786824993
68,36.47018570308689,30.641537377422807,1.2097194638170818,4.61892886184704,767,2233,567,3567,0,2,565,0.15895710681244743,0.6260162601626016
69,36.65984822656953,30.81100952405272,1.2139099193902814,4.634928783126525,741,2242,613,3596,0,7,606,0.17046718576195774,0.6234705228031145
70,36.91794909173624,31.041690299519434,1.2196008814034895,4.656657910813325,792,2258,568,3618,0,4,564,0.15699281370923163,0.6241017136539525
71,36.702270157276935,30.848920230376763,1.2148462112434304,4.638503715656735,809,2292,540,3641,0,3,537,0.14831090359791266,0.629497390826696
72,36.47619106051931,30.646902903436565,1.2098522590171714,4.619435898065559,806,2295,566,3667,0,10,556,0.15434960458140168,0.6258521952549768
73,36.429512466596776,30.605198532149075,1.2088198731872606,4.615494061260449,791,2304,598,3693,0,16,582,0.1619279718386136,0.6238830219333875
74,36.431388810706686,30.606874885965503,1.2088613806066604,4.615652544134517,813,2319,589,3721,0,24,565,0.15829078204783661,0.6232195646331631
75,36.44824368428256,30.62193343534928,1.209234202608802,4.617076046324517,879,2333,533,3745,0,35,498,0.1423230974632844,0.6229639519359146
76,36.354959401217215,30.5385944924999,1.2071700753941612,4.6091948333231585,916,2349,504,3769,0,38,466,0.13372247280445743,0.6232422393207747
77,36.255419300854406,30.44967607123962,1.2049655759577862,4.600777653657,934,2365,496,3795,0,48,448,0.13069828722002635,0.6231884057971014
78,35.81338528788126,30.054928401971445,1.1951514291510947,4.563305456758727,928,2378,520,3826,0,60,460,0.1359121798222687,0.6215368531102979
79,35.719387270956126,29.971010798298096,1.1930592679101562,4.555317204747865,864,2387,608,3859,0,69,539,0.15755377040684115,0.618554029541332
80,35.2685831797334,29.56867475202283,1.1829998623550255,4.516908565355554,882,2398,613,3893,0,79,534,0.15746211148214745,0.6159773953249422
81,35.89977641320455,30.132062657319956,1.1970726663156739,4.570641089568936,828,2411,685,3924,0,99,586,0.17456676860346584,0.6144240570846076
82,35.46013111375492,29.73960339497299,1.1872793378604012,4.533248380921533,942,2437,577,3956,0,65,512,0.14585439838220424,0.6160262891809909
83,35.537932026101274,29.80903998993319,1.189015328261302,4.53987670790679,897,2454,635,3986,0,79,556,0.15930757651781235,0.6156547917711992
84,35.78899676277707,30.03315447126606,1.1946087774834124,4.561233514027574,929,2470,613,4012,0,83,530,0.15279162512462613,0.6156530408773679
85,35.353471011572154,29.64442018885463,1.184897340564018,4.524153482153519,966,2494,581,4041,0,83,498,0.14377629299678296,0.6171739668398911
86,35.262162767293376,29.562946114341003,1.1828562864618126,4.516360366490557,918,2500,656,4074,0,84,572,0.16102110947471773,0.6136475208640157
87,35.39456690747543,29.681092697737085,1.1858154020211658,4.527658807717178,907,2516,685,4108,0,94,591,0.16674780915287243,0.6124634858812074
88,34.80617517041918,29.156197423567562,1.1726368908559879,4.477340855995589,963,2533,651,4147,0,94,557,0.15698095008439836,0.6108029901133349
89,35.26829320348379,29.568416018694137,1.1829933779752078,4.5168838068144295,863,2551,770,4184,0,109,661,0.18403441682600383,0.6097036328871893
90,34.96351505732431,29.296523117999662,1.1761681383503997,4.490823800974253,955,2578,688,4221,0,93,595,0.16299455105425253,0.6107557450841032
91,35.06153485544337,29.383956295902898,1.1783653614140657,4.49921319812643,902,2596,760,4258,0,100,660,0.17848755284170972,0.6096759041803663
92,35.22830363469133,29.532735867920014,1.1820989704619744,4.513468796309355,945,2618,726,4289,0,113,613,0.16927022615994405,0.6103986943343437
93,36.172124980971375,30.375277355558328,1.2031193184819549,4.593728306931097,1010,2640,659,4309,0,88,571,0.15293571594337432,0.6126711533998608
94,36.18831281966054,30.389735843509914,1.2034782403331485,4.595098735817479,1168,2677,480,4325,0,76,404,0.11098265895953757,0.6189595375722543
95,36.50527021957384,30.67288436546472,1.2104951772679313,4.621890676841192,1180,2685,473,4338,0,58,415,0.10903642231443061,0.6189488243430152
96,36.6968725544735,30.84409652181811,1.2147271011171583,4.638048931538241,1219,2706,424,4349,0,58,366,0.09749367670728903,0.622212002759255
97,36.9023905489497,31.027782849656404,1.2192582017401128,4.655349497553158,1245,2718,393,4356,0,71,322,0.09022038567493113,0.6239669421487604
98,36.97060430423147,31.08875939184786,1.2207602648343365,4.661084647549285,1267,2730,363,4360,0,51,312,0.08325688073394495,0.6261467889908257
99,37.07427922276694,31.181443323484828,1.2230414130585499,4.6697944862235525,1245,2759,360,4364,0,63,297,0.08249312557286893,0.632218148487626
100,37.395553987745686,31.468723350700238,1.2300969246698106,4.6967337123756385,1261,2782,322,4365,0,49,273,0.07376861397479954,0.6373424971363115
101,37.49587662166096,31.558450612425453,1.2322959641809608,4.705130045054577,1221,2851,294,4366,0,50,244,0.0673385249656436,0.6530004580852038
102,37.664646615990286,31.709417597859776,1.2359909282912382,4.719238089839273,1246,2852,268,4366,0,50,218,0.061383417315620706,0.6532295006871278
103,37.72953221593815,31.767465702850345,1.2374100310182248,4.7246564820695856,1239,2878,249,4366,0,31,218,0.057031607879065506,0.6591846083371508
104,37.67872206936649,31.72200947913369,1.2362988394822814,4.72041375075053,1237,2885,244,4366,0,44,200,0.055886394869445716,0.6607879065506184
105,37.7253467010737,31.76372112956763,1.2373185148408865,4.724307056665203,1234,2885,247,4366,0,37,210,0.05657352267521759,0.6607879065506184
0,2.325140769936443,1.394942836187438,0.1930599485139443,0.7371379852350601,0,0,25,25,0,2,23,1,0
1,2.863228204550852,1.7945510832824743,0.22180091196136148,0.8468762093070165,12,0,22,34,0,2,20,0.6470588235294118,0
2,3.405123532945355,2.2055382812834514,0.24897052392982905,0.9506147277320743,11,9,22,42,0,2,20,0.5238095238095238,0.21428571428571427
3,3.7278557342898195,2.4536234596806636,0.26446330227737214,1.0097689723317846,13,13,20,46,0,4,16,0.43478260869565216,0.2826086956521739
4,4.0508957900225475,2.704074673584839,0.27952891095876947,1.0672922054789382,8,21,24,53,0,5,19,0.4528301886792453,0.39622641509433965
5,4.468412969727416,3.03057017513132,0.29842020265201996,1.1394225919440761,15,21,30,66,0,8,22,0.45454545454545453,0.3181818181818182
6,4.949109487382097,3.4099135418250412,0.3194557622854266,1.2197401832716286,19,28,29,76,0,7,22,0.3815789473684211,0.3684210526315789
7,5.410491617770162,3.777062266169789,0.3390136390113986,1.2944157125889764,22,33,33,88,0,9,24,0.375,0.375
8,6.174612547178158,4.390800838133458,0.3702250716885223,1.4135866373561763,27,41,31,99,0,12,19,0.31313131313131315,0.41414141414141414
9,6.556911534600921,4.70021004535308,0.38535313927785375,1.471348349969987,18,55,43,116,0,17,26,0.3706896551724138,0.47413793103448276
10,7.292727715916292,5.299596601680172,0.41366872182259135,1.5794623924135307,25,61,48,134,0,20,28,0.3582089552238806,0.4552238805970149
11,7.97569413537069,5.859990348776947,0.43910833306662533,1.6765954535271141,29,74,49,152,0,19,30,0.3223684210526316,0.4868421052631579
12,8.682769094443733,6.443800316611611,0.4646916331349691,1.7742771446971544,32,85,54,171,0,24,30,0.3157894736842105,0.49707602339181284
13,9.415130795085842,7.051969084336763,0.4904675248724503,1.8726941858766284,31,103,56,190,0,25,31,0.29473684210526313,0.5421052631578948
14,9.996804063065124,7.537286151796472,0.51046598158406,1.9490519296845916,38,110,63,211,0,32,31,0.2985781990521327,0.5213270142180095
15,10.776798623117575,8.190954263808333,0.5366846783472017,2.0491596809620414,44,123,70,237,0,39,31,0.29535864978902954,0.5189873417721519
16,11.57271037609669,8.861066874074666,0.5627939343819298,2.148849567640095,52,140,69,261,0,48,21,0.26436781609195403,0.5363984674329502
17,12.150277331223057,9.349146909761007,0.5813666912468414,2.2197637302152122,53,155,83,291,0,60,23,0.2852233676975945,0.5326460481099656
18,12.736336699494174,9.845841689224788,0.5999140587351566,2.290580951534234,58,173,89,320,0,68,21,0.278125,0.540625
19,13.222941972565419,10.25928502703865,0.6150986113357457,2.3485583341910297,66,183,109,358,0,83,26,0.30446927374301674,0.5111731843575419
20,13.816170304623972,10.764523118616296,0.6333607367185763,2.418286449289109,65,205,130,400,0,106,24,0.325,0.5125
21,14.352892898931168,11.222716357465824,0.6496592821909215,2.480517259274428,87,218,141,446,0,120,21,0.31614349775784756,0.48878923766816146
22,15.102853772224881,11.864567680203352,0.672097113438429,2.5661889785830927,86,245,161,492,0,137,24,0.32723577235772355,0.49796747967479676
23,16.120812114937653,12.738602805996738,0.701967969780189,2.6802413391607223,115,265,153,533,0,137,16,0.2870544090056285,0.4971857410881801
24,16.558325054284772,13.115194643396832,0.7146119720710835,2.728518438816864,111,310,157,578,0,141,16,0.27162629757785467,0.5363321799307958
25,17.446943811683248,13.88170375046453,0.7399554844038847,2.8252845768148336,120,331,178,629,0,166,12,0.28298887122416533,0.5262321144674086
26,18.139134370801997,14.480208802695273,0.7593996462108294,2.8995259218958944,130,362,192,684,0,178,14,0.2807017543859649,0.5292397660818714
27,18.6438922244448,14.917399662231954,0.7734229846102131,2.953069577602631,130,405,207,742,0,189,18,0.27897574123989216,0.545822102425876
28,19.41118013281279,15.583134001203234,0.7945001405227406,3.0335459910868288,146,427,229,802,0,213,16,0.2855361596009975,0.5324189526184538
29,19.889926016584926,15.999194036106127,0.8075104110427666,3.0832215694360183,153,470,243,866,0,224,19,0.2806004618937644,0.5427251732101617
30,20.592481878762324,16.610661503464048,0.8264155495902058,3.1554048257080582,175,493,263,931,0,252,11,0.2824919441460795,0.5295381310418904
31,21.06746833136032,17.024651149469676,0.8390752641659821,3.2037419177246584,176,543,289,1008,0,277,12,0.2867063492063492,0.5386904761904762
32,21.178845173243417,17.12179181171782,0.8420299429581426,3.2150234185674518,195,569,326,1090,0,309,17,0.29908256880733947,0.5220183486238532
33,21.751351052929543,17.621509768895987,0.8571368702711175,3.272704413762449,197,597,391,1185,0,367,24,0.329957805907173,0.5037974683544304
34,21.997882381567898,17.8368944770585,0.8636012632000646,3.2973866413093376,214,633,447,1294,0,416,31,0.3454404945904173,0.4891808346213292
35,22.551939086259065,18.321373202630788,0.8780419758473801,3.3525239077809053,244,664,494,1402,0,457,37,0.35235378031383735,0.47360912981455067
36,23.706049868883714,19.332353144941944,0.9077483766671607,3.4659483472746135,273,720,517,1510,0,486,31,0.3423841059602649,0.4768211920529801
37,24.506241023678285,20.034667905376885,0.928062345307835,3.543510772993552,271,826,523,1620,0,491,32,0.3228395061728395,0.5098765432098765
38,24.95157461883754,20.42599189163978,0.9392718867768943,3.5863108404208677,284,902,559,1745,0,517,42,0.32034383954154727,0.5169054441260745
39,25.280754360383476,20.71545540604886,0.9475148773147304,3.617784077019879,308,949,620,1877,0,577,43,0.3303143313798615,0.5055940330314331
40,26.1517305635533,21.482168431848827,0.9691544046933822,3.7004077270110987,343,1003,669,2015,0,621,48,0.33200992555831266,0.4977667493796526
41,26.714305188023438,21.978013309655324,0.9830039747556426,3.7532879036124536,362,1106,687,2155,0,638,49,0.3187935034802784,0.5132250580046404
42,27.579920031320686,22.74186053675224,1.0041255554764774,3.833933939092003,388,1177,737,2302,0,689,48,0.32015638575152044,0.5112945264986968
43,28.720742974017192,23.75017157473988,1.031628026265102,3.9389433730122074,414,1285,752,2451,0,701,51,0.3068135454916361,0.5242758057935537
44,29.37137204885408,24.32601360314892,1.0471498660897476,3.998208579615399,404,1435,766,2605,0,711,55,0.2940499040307102,0.5508637236084453
45,30.14868614967011,25.014698769810586,1.0655445505368784,4.068442829322628,441,1528,794,2763,0,735,59,0.2873688020267825,0.5530220774520449
46,30.832295745710983,25.620991305859143,1.0815914875164168,4.129712952335405,451,1641,823,2915,0,763,60,0.2823327615780446,0.5629502572898799
47,31.093783986410834,25.853056375050233,1.0876981834899329,4.153029427870654,465,1746,866,3077,0,803,63,0.28144296392590185,0.5674358141046474
48,31.5644130740361,26.270936260963932,1.0986461310149835,4.19483068205721,523,1790,908,3221,0,841,67,0.28190003104625894,0.55572803477181
49,32.42215800911952,27.033212218084003,1.1184604471960515,4.270485343839469,540,1898,917,3355,0,843,74,0.27332339791356186,0.5657228017883755
50,32.78929565782337,27.35974451689063,1.1268879726464118,4.3026631682862995,544,2039,896,3479,0,797,99,0.2575452716297787,0.5860879563092842
51,33.582592829285076,28.065816807296095,1.1449912498467678,4.371784772142204,591,2117,880,3588,0,792,88,0.24526198439241917,0.5900222965440357
52,33.96347445650651,28.405064035530053,1.1536323515234128,4.404778069453033,615,2251,829,3695,0,742,87,0.22435723951285522,0.6092016238159675
53,34.34458289632175,28.744668770534204,1.1622463279936461,4.437667797793923,646,2341,803,3790,0,723,80,0.21187335092348286,0.6176781002638523
54,34.79691766205821,29.147941787908024,1.172428955012309,4.476546919137907,662,2417,809,3888,0,708,101,0.2080761316872428,0.621656378600823
55,35.30575297003715,29.601840464946303,1.1838308972830067,4.520081607807841,702,2511,761,3974,0,654,107,0.19149471565173629,0.6318570709612481
56,35.61535033390324,29.87814117056857,1.1907415244656845,4.546467638868979,716,2604,742,4062,0,616,126,0.18266863613983259,0.6410635155096012
57,35.800431671540494,30.04336341612943,1.1948632228211573,4.562205032589871,739,2672,735,4146,0,590,145,0.1772793053545586,0.6444766039556199
58,36.12471355220057,30.33293238615512,1.2020677891792395,4.589713376866188,776,2720,723,4219,0,570,153,0.17136762265939795,0.6447025361460061
59,36.57740532519123,30.737338729274477,1.2120892934921543,4.627977302424591,817,2777,686,4280,0,532,154,0.1602803738317757,0.6488317757009345
60,36.76635975693057,30.906197721707322,1.216260045046328,4.6439019901768885,850,2873,607,4330,0,463,144,0.14018475750577367,0.6635103926096998
61,36.8906088046543,31.017251553876033,1.2189986746898342,4.654358576088459,886,2917,574,4377,0,427,147,0.13114005026273703,0.6664381996801462
62,37.080582790285725,31.187078955583097,1.2231800411646923,4.670323793537919,912,2942,562,4416,0,400,162,0.1272644927536232,0.666213768115942
63,37.15256192542747,31.251433755601948,1.224762450341155,4.6763657194844095,942,2990,519,4451,0,354,165,0.11660301055942485,0.6717591552460122
64,37.29608680329856,31.37977055001876,1.2279146940769339,4.688401559202834,988,3003,489,4480,0,309,180,0.10915178571428572,0.6703125
65,37.301389503190144,31.384512481406624,1.2280310799928016,4.6888459417906985,1013,3029,466,4508,0,269,197,0.1033717834960071,0.6719165927240461
66,37.4216029196736,31.492020267605795,1.2306680975989823,4.69891455446884,1056,3032,441,4529,0,237,204,0.0973724884080371,0.6694634577169353
67,37.53647305163681,31.594762218808732,1.2331852671907322,4.708525565637341,1058,3064,423,4545,0,213,210,0.09306930693069307,0.6741474147414741
0,2.3251407699364424,1.394942836187438,0.1930599485139443,0.7371379852350601,0,0,25,25,0,5,20,1,0
1,2.7579108177629896,1.715602952041965,0.21632804760247692,0.825979818118548,10,0,25,35,0,2,23,0.7142857142857143,0
2,3.283688391389235,2.112795521589713,0.2430155012791464,0.9278773685203768,8,9,29,46,0,2,27,0.6304347826086957,0.1956521739130435
3,3.883155022632176,2.573775065744438,0.27175810425971925,1.037621852628019,14,12,33,59,0,4,29,0.559322033898305,0.2033898305084746
4,4.409083860426113,2.983996650377055,0.2957728171799932,1.129314392869065,18,21,29,68,0,5,24,0.4264705882352941,0.3088235294117647
5,4.763437975566473,3.262983306177668,0.3114151200618274,1.1890395493269774,18,25,39,82,0,7,32,0.47560975609756095,0.3048780487804878
6,5.0917523017501205,3.523121584524071,0.32556486583936856,1.2430658513866797,16,36,46,98,0,11,35,0.46938775510204084,0.3673469387755102
7,5.594381490284574,3.924147740181379,0.346652287757267,1.3235814623459285,29,36,50,115,0,12,38,0.43478260869565216,0.3130434782608696
8,6.120041685011683,4.346755667014403,0.368040494301322,1.405245523695957,36,44,55,135,0,14,41,0.4074074074074074,0.32592592592592595
9,6.6659210897798,4.788697592047623,0.3896124240576211,1.4876110736745534,37,58,55,150,0,18,37,0.36666666666666664,0.38666666666666666
10,6.9862773050832825,5.049380796607743,0.401997388551527,1.534899119924012,44,67,53,164,0,18,35,0.3231707317073171,0.40853658536585363
11,7.529288892996401,5.493285439740712,0.42256675444929426,1.6134366988063957,47,78,62,187,0,29,33,0.3315508021390374,0.41711229946524064
12,8.166473679621424,6.017164398514192,0.4460830583430103,1.7032262227642212,52,95,62,209,0,31,31,0.2966507177033493,0.45454545454545453
13,8.626619321955186,6.397313627067168,0.46268608761826685,1.7666196072697464,52,109,73,234,0,40,33,0.31196581196581197,0.4658119658119658
14,9.25496994562796,6.9186846363395835,0.4848894038145678,1.8513959054738045,59,124,82,265,0,44,38,0.30943396226415093,0.4679245283018868
15,9.937360553133335,7.487602271268692,0.5084403981228509,1.9413178837417941,66,139,98,303,0,53,45,0.3234323432343234,0.45874587458745875
16,10.578991236582313,8.024886468406537,0.5300972160364824,2.0240075521392957,71,166,101,338,0,63,38,0.2988165680473373,0.4911242603550296
17,11.308638669918173,8.638404054826665,0.5541996370944638,2.116034977997043,82,185,108,375,0,71,37,0.288,0.49333333333333335
18,12.145660212997868,9.345239458166333,0.5812194019461681,2.219201352885369,82,219,110,411,0,82,28,0.26763990267639903,0.5328467153284672
19,12.998038798328501,10.068082862821278,0.608104062086403,2.3218518734208105,86,253,109,448,0,83,26,0.24330357142857142,0.5647321428571429
20,13.748242097732872,10.706605556299149,0.6312830557692624,2.410353485664457,87,288,110,485,0,88,22,0.2268041237113402,0.5938144329896907
21,14.40592322854904,11.268041283740741,0.6512585168470056,2.4866234279612947,95,310,119,524,0,97,22,0.22709923664122136,0.5916030534351145
22,15.013660676606497,11.788136755585288,0.6694483609666664,2.5560755600545426,95,340,134,569,0,110,24,0.23550087873462214,0.5975395430579965
23,15.722240231570646,12.396011161159578,0.6903494297079561,2.6358796407031053,113,360,143,616,0,125,18,0.23214285714285715,0.5844155844155844
24,16.511766773810283,13.075093596129149,0.7132717915941955,2.7234013860869277,115,394,158,667,0,132,26,0.2368815592203898,0.5907046476761619
25,17.267196015785114,13.726485541925161,0.7348644379709371,2.8058460358890343,116,433,174,723,0,152,22,0.24066390041493776,0.598893499308437
26,18.010211633589094,14.36864372057225,0.7557971140223638,2.8857707989944803,130,466,184,780,0,161,23,0.2358974358974359,0.5974358974358974
27,18.552641051537474,14.838317794146917,0.7708972798357758,2.9434259775547824,131,507,204,842,0,178,26,0.24228028503562946,0.6021377672209026
28,19.09112047847782,15.305269788545324,0.785742596023726,3.000108093908773,154,523,231,908,0,207,24,0.2544052863436123,0.5759911894273128
29,19.72067347761585,15.852044939576984,0.8029229041212731,3.0657056339175877,155,566,251,972,0,233,18,0.25823045267489714,0.5823045267489712
30,20.58829271221017,16.60701237459619,0.8263034662972373,3.154976871316723,171,599,273,1043,0,256,17,0.26174496644295303,0.5743048897411314
31,21.39550911046033,17.31083305382352,0.8477629551510373,3.2369131014857784,182,652,281,1115,0,261,20,0.2520179372197309,0.5847533632286995
32,22.26997966987892,18.07474991785884,0.8707080617400159,3.3245216902800605,193,710,278,1181,0,262,16,0.23539373412362405,0.6011854360711262
33,22.941856405841616,18.66266636260038,0.8881337825595038,3.3910562606817427,199,769,288,1256,0,274,14,0.22929936305732485,0.6122611464968153
34,23.363500844622344,19.03203910754039,0.8989826246773851,3.4324791124045624,215,809,316,1340,0,293,23,0.23582089552238805,0.6037313432835821
35,24.29747078799622,19.851329609948586,0.9227840180853619,3.5233571599622886,232,841,358,1431,0,337,21,0.2501747030048917,0.5877009084556254
36,25.121350020385897,20.57526186893572,0.9435277295462643,3.60256042190392,251,909,356,1516,0,334,22,0.23482849604221637,0.5996042216358839
37,25.61269055735244,21.007516975248734,0.9557907434554862,3.649382838648219,265,967,378,1610,0,364,14,0.23478260869565218,0.6006211180124224
38,26.07509878371934,21.414663182396772,0.9672602191424203,3.69317538218015,280,1003,421,1704,0,399,22,0.24706572769953053,0.5886150234741784
39,26.942276677464154,22.1790776268516,0.9885884822026104,3.7746105684099676,292,1061,454,1807,0,431,23,0.25124515771997785,0.5871610403984505
40,27.761281951211934,22.902036006438884,1.008522743254781,3.850723201518254,298,1133,484,1915,0,461,23,0.25274151436031334,0.591644908616188
41,28.632752781853018,23.672338621144004,1.0295199201471532,3.930894240561859,327,1204,500,2031,0,477,23,0.24618414574101427,0.5928114229443624
42,29.234469586600596,24.204801241975158,1.0438934300166016,3.9857749146088435,348,1284,525,2157,0,497,28,0.24339360222531292,0.5952712100139083
43,29.97438739966156,24.860206566429724,1.061433757840568,4.0527470753912604,363,1358,569,2290,0,537,32,0.248471615720524,0.5930131004366812
44,30.339350258880916,25.183740305524395,1.0700322544702239,4.085577698886308,386,1427,611,2424,0,574,37,0.25206270627062705,0.5886963696369637
45,31.046920786499676,25.81146023000453,1.086605021159369,4.148855535335776,413,1484,674,2571,0,623,51,0.2621548035783742,0.5772073123298328
46,31.276682208291184,26.01542353692413,1.0919593468875048,4.169299324479561,427,1563,743,2733,0,686,57,0.27186242224661544,0.5718990120746432
47,31.670700458595643,26.365347095030042,1.1011110754570177,4.204242288108611,481,1605,805,2891,0,744,61,0.2784503631961259,0.5551712210307852
48,32.0242028125116,26.679444296145153,1.109289503396809,4.2354690129696335,503,1681,860,3044,0,787,73,0.28252299605781866,0.5522339027595269
49,31.97141164623694,26.632528553017103,1.1080700759512963,4.230813017268587,521,1747,916,3184,0,836,80,0.2876884422110553,0.5486809045226131
50,32.47216927755397,27.077683267680637,1.1196103039359788,4.274875705937371,550,1775,982,3307,0,884,98,0.29694587239189596,0.5367402479588751
51,32.808251167220874,27.37660767690369,1.1273222338394164,4.304321256477776,578,1872,976,3426,0,860,116,0.28488032691185056,0.5464098073555166
52,33.29464257449179,27.809447117972365,1.1384367928625296,4.346758663656929,610,1947,976,3533,0,845,131,0.2762524766487405,0.5510897254457968
53,33.50171577151294,27.993800687231733,1.1431521873036488,4.364762896977569,633,2046,965,3644,0,824,141,0.26481888035126233,0.5614709110867179
54,33.677645359918316,28.150464414461247,1.1471507622646706,4.380030183192377,684,2092,976,3752,0,818,158,0.2601279317697228,0.5575692963752665
55,34.00868861039652,28.445346163678902,1.1546559795074234,4.408686467210165,691,2154,1009,3854,0,830,179,0.26180591593149977,0.5588998443175921
56,33.781379172729764,28.242854171827002,1.1495051888666092,4.389019812036146,698,2250,1014,3962,0,822,192,0.25593134780413934,0.5678950025239778
57,34.21174514602513,28.626279884983315,1.159247507008678,4.426217754033133,695,2282,1084,4061,0,857,227,0.2669293277517853,0.5619305589756217
58,34.56902011801,28.944736030409388,1.167304244596356,4.4569798430042695,769,2341,1033,4143,0,832,201,0.24933622978517983,0.5650494810523775
59,35.120629599152814,29.436673283621083,1.1796890466197916,4.504267268911933,817,2421,977,4215,0,782,195,0.231791221826809,0.5743772241992883
60,35.512968299046285,29.78675942868044,1.188458444792914,4.537750425572945,790,2558,930,4278,0,740,190,0.21739130434782608,0.5979429640018701
61,36.08889501190461,30.300942940944488,1.2012730713313546,4.586678999628811,857,2633,843,4333,0,664,179,0.19455342718670668,0.6076621278559889
62,36.61474624497232,30.770705677165747,1.2129140801107978,4.631126487695773,863,2757,763,4383,0,594,169,0.17408167921514944,0.6290212183436003
63,36.92169461464839,31.0450383772803,1.2196833700198009,4.656972867348327,947,2846,627,4420,0,479,148,0.1418552036199095,0.6438914027149322
64,37.201365043734654,31.295070241563266,1.225834770261987,4.680460031909407,976,2917,561,4454,0,401,160,0.12595419847328243,0.6549169286035025
65,37.30578149182645,31.38844003074544,1.2281274730545504,4.689213988026463,999,2982,493,4474,0,319,174,0.11019222172552526,0.6665176575771122
66,37.38356318064016,31.45799956197557,1.2298339585907634,4.695729660073824,1034,3027,431,4492,0,254,177,0.09594835262689225,0.6738646482635797
67,37.38111216357225,31.45580755029289,1.2297802027560873,4.69552441052324,1047,3046,414,4507,0,206,208,0.09185711116041713,0.6758375859773685
68,37.47239341352014,31.53744668789792,1.2317813958838595,4.703165329738371,1086,3049,385,4520,0,185,200,0.08517699115044247,0.6745575221238939
69,37.5610713388933,31.616764986924274,1.233723959842628,4.710582392126398,1096,3051,385,4532,0,170,215,0.08495145631067962,0.6732127096204766
70,37.58881970111122,31.641586125864425,1.2343314967493333,4.712902078497454,1122,3059,362,4543,0,168,194,0.07968302883557121,0.6733436055469953
71,37.654029222880034,31.69991941483528,1.2357586394055173,4.718351168639246,1118,3075,359,4552,0,152,207,0.0788664323374341,0.6755272407732865
72,37.70903742054616,31.749130177950946,1.2369618805386258,4.722945362056573,1169,3075,314,4558,0,139,175,0.06888986397542782,0.6746379991224221
73,37.703424360125595,31.74410856106273,1.2368391281073852,4.722476670955471,1178,3075,309,4562,0,125,184,0.06773345024112232,0.6740464708461201
74,37.745197210869904,31.781480544271787,1.2377525157090479,4.725964150889091,1189,3075,300,4564,0,125,175,0.06573181419807186,0.6737510955302366
75,37.72811622562131,31.766198884473212,1.237379070804321,4.724538270343772,1175,3099,291,4565,0,113,178,0.06374589266155531,0.6788608981380065
76,37.753689085890294,31.789077978999863,1.2379381542602812,4.726672952630165,1181,3099,285,4565,0,99,186,0.0624315443592552,0.6788608981380065
77,37.735611636023705,31.77290468856951,1.2375429513584146,4.725163996095767,1185,3099,281,4565,0,102,179,0.061555312157721795,0.6788608981380065
78,37.7422270668853,31.778823258271846,1.237687582919773,4.725716225693679,1204,3099,262,4565,0,90,172,0.05739320920043812,0.6788608981380065
79,37.731958730318446,31.769636592803963,1.237463085144523,4.7248590523699985,1202,3099,264,4565,0,86,178,0.05783132530120482,0.6788608981380065
80,37.739724465271834,31.776584272773746,1.2376328701411097,4.725507322356961,1208,3099,258,4565,0,74,184,0.05651697699890471,0.6788608981380065
81,37.73029380439307,31.768147060153318,1.237426682766742,4.724720061473015,1217,3099,249,4565,0,60,189,0.05454545454545454,0.6788608981380065
82,37.738181966274794,31.775204258630648,1.2375991468695413,4.7253785607746135,1217,3099,249,4565,0,61,188,0.05454545454545454,0.6788608981380065
83,37.731016009123955,31.76879318319292,1.2374424733064435,4.724780352624606,1223,3099,243,4565,0,57,186,0.053231106243154434,0.6788608981380065
84,37.75225429484819,31.787794308285342,1.2379067896639921,4.726553196898878,1220,3099,246,4565,0,68,178,0.05388828039430449,0.6788608981380065
85,37.72179024359506,31.76053935565231,1.2372407503277452,4.724010137615026,1228,3099,238,4565,0,64,174,0.05213581599123768,0.6788608981380065
86,37.751059357671494,31.78672523012832,1.2378806679806573,4.72645345956251,1227,3099,239,4565,0,51,188,0.05235487404162103,0.6788608981380065
87,37.721790243595095,31.760539355652295,1.2372407503277447,4.724010137615028,1228,3099,238,4565,0,53,185,0.05213581599123768,0.6788608981380065
88,37.74552404277425,31.78177295007326,1.2377596607492638,4.7259914319517335,1233,3099,233,4565,0,48,185,0.05104052573932092,0.6788608981380065
89,37.734996927446964,31.77235473468816,1.2375295117046652,4.725112681054176,1234,3099,232,4565,0,48,184,0.05082146768893757,0.6788608981380065
90,37.742972271860445,31.779489966844643,1.2377038746259248,4.725778430389896,1245,3099,221,4565,0,46,175,0.0484118291347207,0.6788608981380065
91,37.72585026168303,31.764171639493696,1.237329525360049,4.724349096829277,1237,3099,229,4565,0,50,179,0.050164293537787515,0.6788608981380065
92,37.74196587592525,31.778589580066686,1.2376818727253662,4.725694423133217,1239,3099,227,4565,0,62,165,0.04972617743702081,0.6788608981380065
93,37.725850261683036,31.764171639493703,1.2373295253600494,4.724349096829276,1237,3099,229,4565,0,61,168,0.050164293537787515,0.6788608981380065
94,37.74196587592527,31.778589580066672,1.2376818727253662,4.725694423133215,1239,3099,227,4565,0,49,178,0.04972617743702081,0.6788608981380065
95,37.72585026168306,31.76417163949371,1.2373295253600485,4.724349096829277,1237,3099,229,4565,0,49,180,0.050164293537787515,0.6788608981380065
96,37.74196587592528,31.778589580066694,1.2376818727253658,4.725694423133213,1239,3099,227,4565,0,59,168,0.04972617743702081,0.6788608981380065
97,37.725850261683036,31.76417163949371,1.2373295253600487,4.724349096829277,1237,3099,229,4565,0,55,174,0.050164293537787515,0.6788608981380065
98,37.74196587592526,31.778589580066665,1.237681872725366,4.7256944231332145,1239,3099,227,4565,0,41,186,0.04972617743702081,0.6788608981380065
0,2.325140769936443,1.3949428361874383,0.19305994851394426,0.73713798523506,0,0,25,25,0,3,22,1,0
1,2.639202977753844,1.6270230252830862,0.21007508447506293,0.8021048679956947,10,0,22,32,0,1,21,0.6875,0
2,3.206493298983787,2.054023834224255,0.23919177570480876,0.9132776890547244,10,9,21,40,0,2,19,0.525,0.225
3,3.7204831609505153,2.447931471791178,0.2641145015236365,1.0084371876357034,10,13,25,48,0,4,21,0.5208333333333334,0.2708333333333333
4,4.2004457598724825,2.8206775844896295,0.28636697979644093,1.0934011955864111,8,21,32,61,0,6,26,0.5245901639344263,0.3442622950819672
5,4.60961369773487,3.14163791663022,0.30467421871983347,1.1633015623848186,17,21,32,70,0,7,25,0.45714285714285713,0.3
6,5.0243601540722995,3.4696012783337036,0.32268580439857625,1.2320730713400183,20,29,31,80,0,11,20,0.3875,0.3625
7,5.514760939107065,3.8604124588385247,0.3433553449613955,1.3109931353071465,21,36,38,95,0,14,24,0.4,0.37894736842105264
8,6.130548405795526,4.35523341532854,0.36846160179503495,1.4068533886719514,28,43,36,107,0,15,21,0.3364485981308411,0.40186915887850466
9,6.686791446816514,4.8056517201964235,0.3904252262796417,1.4907145003404496,24,56,38,118,0,23,15,0.3220338983050847,0.4745762711864407
10,7.319175946585296,5.321228803589486,0.41466827496139413,1.5832788680344139,28,63,41,132,0,28,13,0.3106060606060606,0.4772727272727273
11,8.016897642933575,5.893913442606908,0.44061936233194987,1.6823648379947174,27,76,45,148,0,33,12,0.30405405405405406,0.5135135135135135
12,8.518698040693986,6.308024130931383,0.4588191133469546,1.7518547964156446,27,88,49,164,0,33,16,0.29878048780487804,0.5365853658536586
13,9.267744716842355,6.929310029171781,0.4853355012146478,1.8530991864559279,32,95,58,185,0,43,15,0.31351351351351353,0.5135135135135135
14,9.804723820089457,7.376812726076559,0.5039060761158849,1.9240050178970147,37,108,66,211,0,51,15,0.3127962085308057,0.5118483412322274
15,10.452194291939167,7.918539053045652,0.5258529741099736,2.007802264783534,41,124,74,239,0,58,16,0.30962343096234307,0.5188284518828452
16,11.51609488914148,8.813302466369615,0.5609569179337827,2.1418355048380797,53,132,79,264,0,66,13,0.29924242424242425,0.5
17,12.348250680180936,9.516775051362245,0.5876647531510492,2.243810875667642,49,161,83,293,0,73,10,0.2832764505119454,0.5494880546075085
18,13.241105080729405,10.274734825464781,0.6156617510926574,2.3507085041719638,55,184,85,324,0,76,9,0.2623456790123457,0.5679012345679012
19,13.744859084590813,10.703721531482033,0.6311794921546515,2.409958060954124,57,204,93,354,0,85,8,0.2627118644067797,0.576271186440678
20,14.35503257499511,11.22454495118226,0.6497238464517243,2.4807637773611284,65,216,107,388,0,96,11,0.2757731958762887,0.5567010309278351
21,14.98847468654192,11.76655906800566,0.6686994679980914,2.5532161505381676,70,236,123,429,0,115,8,0.2867132867132867,0.5501165501165501
22,15.399929063550584,12.11931595042445,0.6808819668752369,2.5997311462509045,81,255,140,476,0,126,14,0.29411764705882354,0.5357142857142857
23,16.422612656480283,12.998321353968748,0.7107019684457916,2.7135893340657486,99,268,147,514,0,141,6,0.28599221789883267,0.5214007782101168
24,17.14649010507437,13.62229974918113,0.7314357342419935,2.7927546216512478,105,305,146,556,0,136,10,0.26258992805755393,0.5485611510791367
25,17.71711980109074,14.115167554314326,0.7475749946139733,2.854377252162443,107,341,152,600,0,142,10,0.25333333333333335,0.5683333333333334
26,18.41643940903454,14.72031726025398,0.7671196912563408,2.9290024575242106,116,355,173,644,0,160,13,0.2686335403726708,0.5512422360248447
27,19.49985670505656,15.66016092716652,0.7969179916375552,3.0427777862524827,131,385,183,699,0,170,13,0.26180257510729615,0.5507868383404864
28,20.079802492935592,16.164348180553592,0.8126414610604179,3.1028128513215956,132,440,186,758,0,172,14,0.24538258575197888,0.5804749340369393
29,20.633166572956107,16.646103318298323,0.8275036943629333,3.1595595602948348,154,460,208,822,0,194,14,0.25304136253041365,0.559610705596107
30,21.047627745491276,17.00734921562942,0.8385483741222679,3.2017301557395688,157,490,245,892,0,229,16,0.27466367713004486,0.5493273542600897
31,21.870482398247873,17.725575520309263,0.8602636916476359,3.284643186290973,184,508,264,956,0,253,11,0.27615062761506276,0.5313807531380753
32,22.497818883388895,18.27402405854225,0.8766366617606222,3.347158163086012,182,563,279,1024,0,271,8,0.2724609375,0.5498046875
33,23.180632155960925,18.871801891174442,0.8942855266537963,3.4145447381326766,193,605,303,1101,0,295,8,0.27520435967302453,0.5495004541326067
34,23.633375213148124,19.26862190333997,0.9058921963752776,3.458861113432877,211,649,318,1178,0,312,6,0.2699490662139219,0.5509337860780985
35,24.01656177670791,19.604755589713662,0.9156578878667329,3.4961482991275252,208,692,366,1266,0,360,6,0.2890995260663507,0.5466034755134281
36,24.840656636866395,20.328495671629565,0.9364862380680159,3.575674727168787,243,714,401,1358,0,395,6,0.29528718703976436,0.5257731958762887
37,25.498700001488967,20.90720027768311,0.9529527728653655,3.638546950940485,245,782,425,1452,0,417,8,0.2926997245179063,0.5385674931129476
38,25.974709429493345,21.3262433282365,0.9647759832797208,3.6836901179771147,267,830,455,1552,0,449,6,0.2931701030927835,0.5347938144329897
39,26.249949120880128,21.568702585925976,0.9715794695187865,3.7096670654353687,278,877,499,1654,0,493,6,0.30169286577992743,0.530229746070133
40,26.93714429753319,22.174550177818706,0.9884629305067861,3.77413118920773,294,915,550,1759,0,548,2,0.312677657760091,0.5201819215463331
41,27.745409089364376,22.888015544433443,1.0081382829101952,3.8492552620207467,300,981,588,1869,0,586,2,0.3146067415730337,0.5248796147672552
42,28.81551614743135,23.83401610500062,1.033896235221474,3.9476038072092656,323,1060,597,1980,0,597,0,0.3015151515151515,0.5353535353535354
43,29.211473006829706,24.184442651774894,1.0433459227472288,3.9836844323076024,333,1157,611,2101,0,611,0,0.2908138981437411,0.5506901475487863
44,30.281097998211376,25.132089419415657,1.0686621578632722,4.080346420932495,358,1204,655,2217,0,655,0,0.2954442940911141,0.5430762291384754
45,30.54843411903636,25.36916467229201,1.0749427153620386,4.10432673138233,375,1313,665,2353,0,665,0,0.2826179345516362,0.5580110497237569
46,31.149951721783204,25.902914783966196,1.0890076663393802,4.158029271477633,388,1355,731,2474,0,731,0,0.2954729183508488,0.547696038803557
47,31.727143307499187,26.41548842278047,1.1024189383378409,4.209235946380847,415,1419,764,2598,0,764,0,0.294072363356428,0.546189376443418
48,32.230044886089274,26.86240782094484,1.1140378814450733,4.25359918369937,427,1507,769,2703,0,769,0,0.2844987051424343,0.5575286718460969
49,32.89592380611828,27.454608060387095,1.1293296830762811,4.311986062654888,452,1570,772,2794,0,772,0,0.2763063707945598,0.5619183965640658
50,32.96606940448096,27.517021214812964,1.1309345299310891,4.318113659736886,450,1664,760,2874,0,760,0,0.26443980514961724,0.5789839944328462
51,33.592150715183784,28.074327995874377,1.1452084889132723,4.372614230396128,466,1705,773,2944,0,773,0,0.2625679347826087,0.5791440217391305
52,34.13953470622978,28.561931675314234,1.1576157233975632,4.4199873075179665,496,1787,720,3003,0,720,0,0.23976023976023977,0.595071595071595
53,33.91413226913228,28.3611066639392,1.1525147482476181,4.4005108569454485,490,1867,710,3067,0,710,0,0.23149657645908053,0.6087381806325399
54,33.956221756609345,28.398602674333315,1.1534681114157694,4.404150970860213,509,1885,735,3129,0,727,8,0.2348993288590604,0.602428891019495
55,33.94295518968314,28.386783762133632,1.1531676547744274,4.4030037727750875,530,1911,746,3187,0,741,5,0.23407593347976152,0.5996234703482899
56,33.977100193203036,28.41720322675771,1.153940879828281,4.405956086617072,529,1939,784,3252,0,777,7,0.24108241082410825,0.5962484624846248
57,34.11135799192166,28.53682432822921,1.1569786849173103,4.417554978775183,549,1962,806,3317,0,801,5,0.24299065420560748,0.5914983418751885
58,34.0515907267838,28.483570475255323,1.1556268446568503,4.4123934068716135,567,1990,829,3386,0,828,1,0.24483165977554636,0.5877141169521559
59,34.13665721101722,28.55936759486897,1.1575506750496412,4.419738941098632,595,2014,843,3452,0,838,5,0.24420625724217845,0.5834298957126304
60,34.341133494344035,28.741594326829095,1.1621685064653666,4.437370661049577,651,2044,814,3509,0,802,12,0.23197492163009403,0.5825021373610715
61,34.326365235972084,28.72843155554209,1.1618352921647237,4.436098388265308,665,2100,798,3563,0,761,37,0.22396856581532418,0.5893909626719057
62,34.240612990535034,28.65200616364134,1.1598995301100061,4.42870729678366,761,2126,732,3619,0,700,32,0.2022658192870959,0.5874550980933959
63,34.25983487728401,28.669136703112212,1.1603335833186703,4.430364590853103,737,2152,784,3673,0,668,116,0.21344949632453036,0.5858970868499864
64,33.60090686752083,28.08212533697032,1.1454074874727413,4.37337404307774,865,2179,687,3731,0,600,87,0.1841329402305012,0.5840257303671937
65,33.85847831005426,28.311529472405603,1.1512535323421682,4.395695305306463,736,2202,856,3794,0,599,257,0.22561939905113337,0.5803900896151819
66,33.94597043667319,28.389469967234625,1.15323594648725,4.403264522951318,921,2228,700,3849,0,529,171,0.18186541958950378,0.5788516497791634
67,34.39968248405988,28.79378060145245,1.1634890699751281,4.442412812632309,859,2264,778,3901,0,517,261,0.19943604204050244,0.5803640092284029
68,33.995078870547886,28.433220764007533,1.154347908904594,4.407510197635722,997,2304,654,3955,0,472,182,0.16536030341340077,0.5825537294563843
69,34.370853910846215,28.768084474479082,1.1628389396233632,4.439930496743751,891,2324,798,4013,0,502,296,0.19885372539247445,0.5791178669324695
70,34.50818854807547,28.890504482713915,1.1659344286599493,4.451749636701627,1041,2354,673,4068,0,489,184,0.16543756145526056,0.5786627335299902
71,34.7200257311324,29.07937474741258,1.1707011475644882,4.469949836155316,1003,2396,719,4118,0,469,250,0.17459932005828072,0.5818358426420592
72,34.94167533506318,29.27704354017803,1.1756782970516335,4.488953497833509,1074,2465,630,4169,0,434,196,0.15111537538978173,0.5912688894219237
73,35.22491577667712,29.529713172425698,1.1820231820144416,4.513179422236958,1003,2533,681,4217,0,430,251,0.16148921033910363,0.6006639791320845
74,35.78882368664318,30.032999952041177,1.194604926049471,4.561218808552525,1100,2586,568,4254,0,369,199,0.13352139163140572,0.607898448519041
75,36.08731990968973,30.29953625032251,1.2012381179818796,4.586545541385359,1050,2697,542,4289,0,331,211,0.12636978316623923,0.6288179062718583
76,36.05348583626674,30.26932034361441,1.200487177720295,4.583678314932037,1084,2762,479,4325,0,301,178,0.1107514450867052,0.6386127167630058
77,36.320762766104146,30.50804580174345,1.2064129548673084,4.6063040094933605,1057,2777,526,4360,0,307,219,0.12064220183486239,0.6369266055045871
78,36.50412642192245,30.671862396872342,1.2104698919915342,4.621794133058585,1099,2839,454,4392,0,286,168,0.10336976320582877,0.6464025500910747
79,36.63540919513447,30.789170173125306,1.2133703630585129,4.632868658950684,1080,2877,466,4423,0,275,191,0.10535835405833145,0.6504634863215012
80,36.87757783404054,31.005603772728563,1.2187115976307887,4.653262463681193,1136,2901,414,4451,0,245,169,0.09301280611098629,0.6517636486182881
81,37.0020381429918,31.116859721405312,1.2214521252349329,4.6637262963515616,1118,2946,417,4481,0,239,178,0.09305958491408167,0.6574425351484043
82,37.19934994477748,31.293268430047434,1.2257905030571803,4.6802910116728675,1142,2991,373,4506,0,218,155,0.08277851753217931,0.6637816245006658
83,37.23261326313825,31.323011496872674,1.2265211213004008,4.683080644965166,1122,3025,381,4528,0,210,171,0.08414310954063604,0.668065371024735
84,37.435004227031705,31.504006003720324,1.2309618954042467,4.7000363279071244,1149,3041,357,4547,0,199,158,0.0785133054761381,0.6687926105124258
85,37.5243100491265,31.583882820241804,1.2329188588251185,4.7075083700595455,1153,3073,337,4563,0,161,176,0.07385492000876616,0.673460442691212
86,37.67503104908355,31.71870747958116,1.2362180993306864,4.72010547017171,1197,3081,295,4573,0,155,140,0.06450907500546688,0.6737371528537065
87,37.71909153184079,31.75812496921006,1.2371817394139224,4.7237848232167945,1196,3097,289,4582,0,148,141,0.06307289393278044,0.6759057180270625
88,37.75507869522556,31.79032122862598,1.237968530803687,4.726788935795896,1213,3097,276,4586,0,144,132,0.06018316615787178,0.6753161796772786
89,37.74605693001985,31.78224970705358,1.2377713104269594,4.726035912539295,1189,3121,276,4586,0,138,138,0.06018316615787178,0.6805494984736153
90,37.746335523639985,31.782498955858475,1.237777400860312,4.726059166921191,1197,3121,268,4586,0,132,136,0.05843872655909289,0.6805494984736153
91,37.74605693001983,31.78224970705359,1.237771310426959,4.7260359125393,1189,3121,276,4586,0,135,141,0.06018316615787178,0.6805494984736153
92,37.74812490906704,31.784099863511784,1.2378165188888255,4.726208526666426,1203,3121,262,4586,0,114,148,0.057130396860008724,0.6805494984736153
93,37.74574006722378,31.781966220128258,1.2377643833594467,4.726009463736068,1195,3121,270,4586,0,122,148,0.05887483645878761,0.6805494984736153
94,37.75878650544586,31.79363852490779,1.23804958086639,4.727098399671672,1212,3121,253,4586,0,104,149,0.055167902311382466,0.6805494984736153
95,37.741506823046194,31.778178882036908,1.2376718368132524,4.725656104196054,1198,3121,267,4586,0,113,154,0.05822067160924553,0.6805494984736153
96,37.75357783172324,31.788978442684027,1.2379357222534288,4.72666366678582,1215,3121,250,4586,0,99,151,0.054513737461840385,0.6805494984736153
97,37.74210486263704,31.778713926496152,1.2376849112745276,4.725706024866377,1204,3121,261,4586,0,105,156,0.05691234191016136,0.6805494984736153
98,37.743582522710895,31.78003593711298,1.2377172158788123,4.725829369719101,1220,3121,245,4586,0,97,148,0.05342346271260358,0.6805494984736153
99,37.757507407462924,31.792494142621265,1.2380216210048736,4.726991643836791,1215,3121,250,4586,0,76,174,0.054513737461840385,0.6805494984736153
100,37.741131872017455,31.777843427040295,1.2376636395235676,4.725624805453622,1226,3121,239,4586,0,86,153,0.05211513301351941,0.6805494984736153
101,37.757017966760436,31.79205625063566,1.2380109222145732,4.726950793910188,1221,3121,244,4586,0,80,164,0.053205407762756216,0.6805494984736153
102,37.74226710265759,31.778859076850225,1.2376884581864318,4.72571956762092,1233,3121,232,4586,0,64,168,0.05058874836458788,0.6805494984736153
103,37.75328664675177,31.788717926840004,1.2379293569628251,4.726639362948969,1227,3121,238,4586,0,66,172,0.051897078063672046,0.6805494984736153
104,37.72348198834278,31.762052868500362,1.2372777418540866,4.7241513779883295,1246,3121,219,4586,0,57,162,0.047754034016572175,0.6805494984736153
105,37.75291821493096,31.7883883003027,1.2379213030360565,4.726608611592218,1227,3121,238,4586,0,50,188,0.051897078063672046,0.6805494984736153
106,37.72348198834277,31.762052868500376,1.2372777418540866,4.7241513779883295,1246,3121,219,4586,0,41,178,0.047754034016572175,0.6805494984736153
107,37.75291821493096,31.788388300302685,1.2379213030360563,4.7266086115922175,1227,3121,238,4586,0,39,199,0.051897078063672046,0.6805494984736153
108,37.72348198834279,31.762052868500326,1.2372777418540866,4.7241513779883295,1246,3121,219,4586,0,44,175,0.047754034016572175,0.6805494984736153
109,37.752918214930965,31.7883883003027,1.237921303036057,4.726608611592216,1227,3121,238,4586,0,54,184,0.051897078063672046,0.6805494984736153
110,37.72348198834276,31.76205286850034,1.2372777418540866,4.724151377988331,1246,3121,219,4586,0,43,176,0.047754034016572175,0.6805494984736153
111,37.75291821493097,31.78838830030269,1.2379213030360572,4.726608611592219,1227,3121,238,4586,0,53,185,0.051897078063672046,0.6805494984736153
112,37.723481988342776,31.76205286850036,1.2372777418540863,4.7241513779883295,1246,3121,219,4586,0,49,170,0.047754034016572175,0.6805494984736153
113,37.75291821493096,31.788388300302664,1.2379213030360565,4.7266086115922175,1227,3121,238,4586,0,33,205,0.051897078063672046,0.6805494984736153
114,37.72348198834278,31.762052868500383,1.2372777418540866,4.724151377988331,1246,3121,219,4586,0,35,184,0.047754034016572175,0.6805494984736153
115,37.75291821493094,31.788388300302696,1.237921303036057,4.726608611592217,1227,3121,238,4586,0,51,187,0.051897078063672046,0.6805494984736153
116,37.723481988342805,31.762052868500348,1.2372777418540866,4.72415137798833,1246,3121,219,4586,0,45,174,0.047754034016572175,0.6805494984736153
117,37.75291821493096,31.788388300302692,1.2379213030360572,4.726608611592219,1227,3121,238,4586,0,54,184,0.051897078063672046,0.6805494984736153
118,37.72348198834279,31.76205286850037,1.2372777418540863,4.7241513779883295,1246,3121,219,4586,0,40,179,0.047754034016572175,0.6805494984736153
119,37.75291821493096,31.7883883003027,1.237921303036057,4.726608611592216,1227,3121,238,4586,0,47,191,0.051897078063672046,0.6805494984736153
120,37.72348198834276,31.762052868500348,1.2372777418540863,4.7241513779883295,1246,3121,219,4586,0,45,174,0.047754034016572175,0.6805494984736153
121,37.75291821493094,31.788388300302685,1.237921303036057,4.726608611592219,1227,3121,238,4586,0,34,204,0.051897078063672046,0.6805494984736153
122,37.72348198834276,31.762052868500355,1.2372777418540866,4.72415137798833,1246,3121,219,4586,0,44,175,0.047754034016572175,0.6805494984736153
123,37.752918214930965,31.78838830030269,1.237921303036057,4.726608611592218,1227,3121,238,4586,0,39,199,0.051897078063672046,0.6805494984736153
124,37.72348198834278,31.76205286850037,1.2372777418540863,4.7241513779883295,1246,3121,219,4586,0,38,181,0.047754034016572175,0.6805494984736153
125,37.75291821493094,31.788388300302692,1.237921303036057,4.726608611592217,1227,3121,238,4586,0,33,205,0.051897078063672046,0.6805494984736153
126,37.723481988342755,31.762052868500355,1.2372777418540866,4.7241513779883295,1246,3121,219,4586,0,34,185,0.047754034016572175,0.6805494984736153
0,2.325140769936443,1.3949428361874379,0.19305994851394429,0.7371379852350601,0,0,25,25,0,2,23,1,0
1,2.5606300784134657,1.568640526446313,0.20588462399318255,0.7861049279739695,12,0,16,28,0,0,16,0.5714285714285714,0
2,3.094374041138833,1.9689286966726816,0.23358299602127672,0.8918623484448747,12,9,9,30,0,0,9,0.3,0.3
3,3.218051808025615,2.0628144517187517,0.23976624376180178,0.9154711125450614,15,9,7,31,0,0,7,0.22580645161290322,0.2903225806451613
4,3.510978715454354,2.2866594953268162,0.25410398908307413,0.9702152310444648,11,13,11,35,0,0,11,0.3142857142857143,0.37142857142857144
5,3.8444367200300804,2.543775033579196,0.2699486519049005,1.0307130345459836,8,21,7,36,0,0,7,0.19444444444444445,0.5833333333333334
6,4.014798019935667,2.675989901803071,0.2778658358388407,1.0609422822937555,8,21,9,38,0,0,9,0.23684210526315788,0.5526315789473685
7,4.410266568269677,2.984924522744426,0.2958257075618447,1.1295163379634068,12,21,8,41,0,0,8,0.1951219512195122,0.5121951219512195
8,4.705246216042642,3.2170366024740122,0.30887369338216847,1.1793359201864613,9,25,10,44,0,0,10,0.22727272727272727,0.5681818181818182
9,5.057142059568805,3.495627737314182,0.32408787820378965,1.2374264440508331,7,29,12,48,0,0,12,0.25,0.6041666666666666
10,5.374880293349635,3.7486262083777726,0.33752443273000926,1.2887296522418534,11,29,11,51,0,0,11,0.21568627450980393,0.5686274509803921
11,5.520065526815797,3.8646563501788833,0.3435754894906802,1.3118336871462333,8,33,15,56,0,0,15,0.26785714285714285,0.5892857142857143
12,5.996029638431079,4.246780305895488,0.36305174826210423,1.3861975842734888,14,33,13,60,0,0,13,0.21666666666666667,0.55
13,6.19972482344876,4.411079854257008,0.37122820115300503,1.4174167680387466,11,38,16,65,0,0,16,0.24615384615384617,0.5846153846153846
14,6.711419602506461,4.825663749723233,0.3913832902002928,1.4943725625829358,13,38,19,70,0,0,19,0.2714285714285714,0.5428571428571428
15,7.231382986018066,5.249444770950957,0.41134566727807886,1.5705925477890283,14,42,21,77,0,0,21,0.2727272727272727,0.5454545454545454
16,7.582072506574792,5.536564619382325,0.42453937281353005,1.6209685143789325,13,48,22,83,0,0,22,0.26506024096385544,0.5783132530120482
17,7.994863266819532,5.875770853491047,0.4398116329549685,1.6792807803735161,16,51,27,94,0,0,27,0.2872340425531915,0.5425531914893617
18,8.433349803787387,6.23746638493193,0.45574938881905697,1.7401340300363994,19,54,31,104,0,0,31,0.2980769230769231,0.5192307692307693
19,8.74892233556808,6.498595614613873,0.46704894208483566,1.7832777788693723,19,59,36,114,0,0,36,0.3157894736842105,0.5175438596491229
20,9.275985284906335,6.9361646307313105,0.4856231546400997,1.854197499534926,28,63,32,123,0,0,32,0.2601626016260163,0.5121951219512195
21,9.56391407003918,7.175921452329331,0.49562110933600645,1.8923715083738426,27,69,40,136,0,0,40,0.29411764705882354,0.5073529411764706
0,2.3251407699364424,1.3949428361874376,0.1930599485139443,0.7371379852350601,0,0,25,25,0,8,17,1,0
1,2.5938380721937904,1.593290421413807,0.2076608331807512,0.7928868175992316,12,0,18,30,0,8,10,0.6,0
2,3.079943661829617,1.9579999953623808,0.23285623266301145,0.8890874338042255,9,9,21,39,0,10,11,0.5384615384615384,0.23076923076923078
3,3.672950399963416,2.411260638863509,0.26186013909620687,0.999829622003699,15,9,23,47,0,15,8,0.48936170212765956,0.19148936170212766
4,4.25494602498293,2.863268629676772,0.28883870468618367,1.1028386906199739,10,21,28,59,0,23,5,0.4745762711864407,0.3559322033898305
5,4.846920976767429,3.3289860205793538,0.3150431041145065,1.2028918520735705,13,25,36,74,0,32,4,0.4864864864864865,0.33783783783783783
6,5.579098543467171,3.911908052623013,0.3460206679110519,1.321169822933107,15,36,44,95,0,41,3,0.4631578947368421,0.37894736842105264
7,6.127880243651173,4.353080397083416,0.3683546851367038,1.4064451614310505,27,39,50,116,0,47,3,0.43103448275862066,0.33620689655172414
8,6.6101218237310455,4.74338893695157,0.3874351274447968,1.4792977593346786,23,52,70,145,0,69,1,0.4827586206896552,0.3586206896551724
9,7.184891892117132,5.2114574898347765,0.40958072500199866,1.5638536772803584,36,57,80,173,0,80,0,0.4624277456647399,0.32947976878612717
10,7.9388555011943955,5.829671503243518,0.43775516938603043,1.6714288285648435,42,72,92,206,0,92,0,0.44660194174757284,0.34951456310679613
11,8.464290199308959,6.2630392000298984,0.4568634149447101,1.7443875843343466,55,85,106,246,0,106,0,0.43089430894308944,0.34552845528455284
12,9.1707472360858,6.84865739398008,0.4819431747766589,1.8401466673290612,62,104,121,287,0,121,0,0.42160278745644597,0.3623693379790941
13,9.775727635086232,7.352605722703663,0.5029120950227969,1.9202098173597697,79,129,116,324,0,116,0,0.35802469135802467,0.39814814814814814
14,10.51354581623618,7.969985675502048,0.5279087084542545,2.0156514322798804,83,157,134,374,0,134,0,0.3582887700534759,0.4197860962566845
15,11.117095185660647,8.477098272707583,0.5479238875940341,2.0920730253590394,93,175,155,423,0,155,0,0.3664302600472813,0.41371158392434987
16,11.944408457607883,9.175008802187946,0.574781060558854,2.194618594861079,105,203,168,476,0,168,0,0.35294117647058826,0.4264705882352941
17,12.698728274713975,9.813926190451012,0.5987325080545796,2.286069576208395,112,242,188,542,0,188,0,0.34686346863468637,0.44649446494464945
18,13.579616185689414,10.562901762181713,0.6261105407280123,2.3906038827796836,141,277,189,607,0,189,0,0.3113673805601318,0.45634266886326197
19,14.253753188307956,11.138007333434661,0.6466642340303063,2.4690816208429878,129,331,218,678,0,218,0,0.3215339233038348,0.4882005899705015
20,14.995540481278704,11.772612368960317,0.6689096082170248,2.5540185041013674,163,366,224,753,0,224,0,0.29747675962815406,0.4860557768924303
21,15.898945724263085,12.547840325633347,0.6955124412250389,2.655592957404694,185,416,231,832,0,231,0,0.2776442307692308,0.5
22,16.586943977400228,13.139847371431685,0.7154351446349807,2.731661461333562,188,478,252,918,0,252,0,0.27450980392156865,0.5206971677559913
23,17.344554338816753,13.793276647883905,0.7370576339671947,2.814220056965652,212,520,275,1007,0,275,0,0.2730883813306852,0.5163853028798411
24,18.162861772098175,14.500746126034418,0.7600617378622866,2.9020539082014594,243,570,281,1094,0,281,0,0.25685557586837293,0.5210237659963437
25,18.891718835774,15.132275714569612,0.7802617798726094,2.97918134133178,247,641,305,1193,0,305,0,0.25565800502933783,0.537300922045264
26,19.686939433554937,15.822723919939232,0.802006993391936,3.0622085202237566,287,693,317,1297,0,317,0,0.24441017733230533,0.5343099460292984
27,20.64371842051582,16.655295952978378,0.8277857951492803,3.1606366723881596,300,767,339,1406,0,339,0,0.2411095305832148,0.5455192034139402
28,21.545670147921886,17.44190460357738,0.851724924297915,3.2520406200465835,313,858,342,1513,0,342,0,0.2260409781890284,0.5670852610707204
29,22.310148729437206,18.10987578125479,0.8717547628303143,3.328518185352109,347,932,345,1624,0,345,0,0.2124384236453202,0.5738916256157636
30,23.03090828229,18.7406518925511,0.8904305714552379,3.3998258182836354,354,1013,377,1744,0,377,0,0.2161697247706422,0.580848623853211
31,23.917008336649424,19.517402466061764,0.9131257467257424,3.4864801238619236,396,1077,405,1878,0,405,0,0.21565495207667731,0.5734824281150159
32,24.725968696112435,20.227706705192293,0.9336015452853147,3.5646604456348374,402,1175,438,2015,0,438,0,0.2173697270471464,0.5831265508684863
33,25.624373286992334,21.01779943787212,0.9560813649117434,3.650492484208474,440,1265,450,2155,0,450,0,0.2088167053364269,0.5870069605568445
34,26.44905041884702,21.74416274636646,0.976486120703515,3.7284015517770546,475,1350,469,2294,0,469,0,0.20444638186573671,0.5884917175239756
35,27.22870692333727,22.431808215986266,0.995582750582281,3.80131595676871,480,1462,506,2448,0,506,0,0.20669934640522875,0.5972222222222222
36,28.22331868418144,23.310305577890702,1.019681965456567,3.893331140834163,529,1559,506,2594,0,506,0,0.19506553585196607,0.6010023130300693
37,29.118141208271084,24.101824268960765,1.041122383630445,3.975194555679882,575,1680,493,2748,0,493,0,0.17940320232896653,0.611353711790393
38,29.949107360125385,24.83780242383612,1.0608368735694729,4.050468062719807,582,1805,523,2910,0,523,0,0.17972508591065292,0.6202749140893471
39,30.791114467098094,25.584451393860434,1.0806281850115922,4.126034888226082,621,1907,543,3071,0,543,0,0.1768153695864539,0.6209703679583197
40,31.654146432739005,26.350641941225845,1.1007273472951884,4.202777144217989,639,2032,562,3233,0,562,0,0.17383235385091247,0.628518403959171
41,32.459086286935225,27.066049328181478,1.1193095574771939,4.273727401276557,679,2154,573,3406,0,573,0,0.16823253082795067,0.632413388138579
42,33.335447156725024,27.84577099101931,1.1393667513728865,4.3503094143328385,708,2272,610,3590,0,610,0,0.16991643454038996,0.6328690807799443
43,34.16453395873547,28.584208397164545,1.1581807769298176,4.422144784641121,741,2399,636,3776,0,636,0,0.1684322033898305,0.6353283898305084
44,34.95034321925025,29.284774656793072,1.1758727205099906,4.489695841947238,765,2530,669,3964,0,669,0,0.1687689202825429,0.6382441977800202
45,35.68228993677373,29.937894241111408,1.1922330689110514,4.5521626267512865,787,2675,682,4144,0,682,0,0.16457528957528958,0.645511583011583
46,36.40083390622111,30.579577105963985,1.2081853736382682,4.613071426618841,867,2767,671,4305,0,671,0,0.15586527293844368,0.6427409988385598
47,36.87698462877554,31.00507353789117,1.2186985282967582,4.653212562587621,887,2906,625,4418,0,625,0,0.14146672702580354,0.6577636939791761
48,37.260965804758676,31.348364321176355,1.2271437041397333,4.685457779442617,950,2966,582,4498,0,582,0,0.12939084037349932,0.6594041796353936
49,37.44674308402296,31.51450503178375,1.2312192183892725,4.701018833849949,942,3058,546,4546,0,546,0,0.12010558732952045,0.6726792784865816
50,37.59993961904606,31.651533186381034,1.2345749199870828,4.713831512677953,976,3089,508,4573,0,508,0,0.11108681390771923,0.6754865514979226
51,37.66972634844744,31.713961898235603,1.2361020557043465,4.719662394507503,1005,3113,468,4586,0,468,0,0.1020497165285652,0.6788050588748364
52,37.70848967124304,31.748640143246515,1.2369499020370134,4.722899625959504,1030,3113,448,4591,0,448,0,0.09758222609453278,0.6780657808756262
53,37.70848967124302,31.748640143246533,1.2369499020370134,4.722899625959507,1031,3113,447,4591,0,447,0,0.09736440862557177,0.6780657808756262
54,37.708489671243065,31.74864014324651,1.2369499020370134,4.722899625959506,1031,3113,447,4591,0,447,0,0.09736440862557177,0.6780657808756262
55,37.708489671243015,31.748640143246476,1.2369499020370134,4.722899625959506,1031,3113,447,4591,0,447,0,0.09736440862557177,0.6780657808756262
56,37.70848967124305,31.748640143246533,1.2369499020370134,4.722899625959506,1031,3113,447,4591,0,447,0,0.09736440862557177,0.6780657808756262
57,37.70848967124302,31.748640143246533,1.2369499020370136,4.722899625959504,1031,3113,447,4591,0,447,0,0.09736440862557177,0.6780657808756262
58,37.70848967124303,31.748640143246504,1.2369499020370136,4.722899625959505,1031,3113,447,4591,0,447,0,0.09736440862557177,0.6780657808756262
59,37.70848967124303,31.748640143246487,1.2369499020370134,4.722899625959506,1031,3113,447,4591,0,447,0,0.09736440862557177,0.6780657808756262
60,37.70590261041965,31.746325676555475,1.2368933258963433,4.722683607967853,1041,3113,437,4591,0,437,0,0.09518623393596166,0.6780657808756262
61,37.70475789203116,31.745301577156777,1.2368682917663865,4.7225880231080195,1050,3113,428,4591,0,418,10,0.09322587671531257,0.6780657808756262
62,37.701947517107214,31.74278733664825,1.2368068299065869,4.722353350552425,1103,3113,375,4591,0,359,16,0.081681550860379,0.6780657808756262
63,37.703851728965496,31.744490897369374,1.2368484744822164,4.722512357113916,1149,3113,329,4591,0,273,56,0.07166194728817252,0.6780657808756262
64,37.70876781120112,31.748888976448576,1.2369559845712819,4.7229228501812575,1183,3113,295,4591,0,199,96,0.06425615334349814,0.6780657808756262
65,37.708784856638204,31.74890422586249,1.2369563573308116,4.722924273444919,1219,3113,259,4591,0,138,121,0.05641472446090177,0.6780657808756262
66,37.69626344208736,31.73770222564174,1.23668251662079,4.721878699824835,1229,3113,249,4591,0,100,149,0.05423654977129166,0.6780657808756262
67,37.7161860160883,31.755525574379526,1.2371182048829517,4.723542236825817,1252,3113,226,4591,0,70,156,0.04922674798518841,0.6780657808756262
68,37.69593638828622,31.73740963631593,1.2366753636164722,4.721851388353803,1248,3113,230,4591,0,59,171,0.050098017861032455,0.6780657808756262
69,37.72270664230245,31.76135920785513,1.237260788281518,4.724086646165793,1261,3113,217,4591,0,48,169,0.04726639076453932,0.6780657808756262
70,37.69593638828619,31.73740963631591,1.2366753636164722,4.721851388353803,1248,3113,230,4591,0,57,173,0.050098017861032455,0.6780657808756262
71,37.72270664230244,31.761359207855136,1.237260788281518,4.7240866461657935,1261,3113,217,4591,0,45,172,0.04726639076453932,0.6780657808756262
72,37.69593638828621,31.737409636315917,1.2366753636164725,4.721851388353802,1248,3113,230,4591,0,46,184,0.050098017861032455,0.6780657808756262
73,37.722706642302434,31.761359207855122,1.2372607882815176,4.724086646165795,1261,3113,217,4591,0,37,180,0.04726639076453932,0.6780657808756262
74,37.69593638828621,31.737409636315952,1.2366753636164727,4.721851388353802,1248,3113,230,4591,0,53,177,0.050098017861032455,0.6780657808756262
75,37.72270664230244,31.761359207855143,1.2372607882815172,4.724086646165795,1261,3113,217,4591,0,49,168,0.04726639076453932,0.6780657808756262
0,2.325140769936443,1.3949428361874385,0.19305994851394429,0.7371379852350601,0,0,25,25,0,7,18,1,0
1,2.6671730732855905,1.6478543499165221,0.21155671617093866,0.8077620071981293,11,0,20,31,0,6,14,0.6451612903225806,0
2,3.128427266754891,1.994740063230765,0.2352935705427431,0.8983936329813828,6,9,26,41,0,9,17,0.6341463414634146,0.21951219512195122
3,3.686312767758063,2.421564800968099,0.2624948610318793,1.0022531057580848,14,9,28,51,0,12,16,0.5490196078431373,0.17647058823529413
4,4.339537581554196,2.9294757007787964,0.292654352613762,1.1174075281616367,14,20,25,59,0,11,14,0.423728813559322,0.3389830508474576
5,4.680509497932136,3.197520405163413,0.3077901890652072,1.1751989037035184,15,25,31,71,0,14,17,0.43661971830985913,0.352112676056338
6,5.075726802700516,3.5103891619936185,0.32488139712784675,1.2404562435790512,13,34,37,84,0,21,16,0.44047619047619047,0.40476190476190477
7,5.435843605008465,3.797315713948746,0.340071826446357,1.298456064613363,18,34,55,107,0,34,21,0.514018691588785,0.3177570093457944
8,6.194816637754068,4.407115813737093,0.3710322464940892,1.4166685775228862,27,40,68,135,0,43,25,0.5037037037037037,0.2962962962962963
9,6.824894711363935,4.9179423661082575,0.39578256222287683,1.5111697830328024,30,55,84,169,0,58,26,0.4970414201183432,0.3254437869822485
10,7.673671214151358,5.611721856618605,0.42795175345019404,1.6339976040825592,54,65,84,203,0,64,20,0.41379310344827586,0.32019704433497537
11,8.354521519720121,6.172343094791636,0.45290495611723336,1.7292734688112545,56,92,84,232,0,66,18,0.3620689655172414,0.39655172413793105
12,9.104494112685591,6.793601580068961,0.47961920488269794,1.8312733277339368,57,115,92,264,0,78,14,0.3484848484848485,0.4356060606060606
13,9.846488133426911,7.411687286404441,0.5053360248537201,1.9294648221687485,66,136,103,305,0,92,11,0.3377049180327869,0.4459016393442623
14,10.49937282918377,7.958099132372718,0.5274341634890856,2.013839533321963,69,164,112,345,0,102,10,0.32463768115942027,0.4753623188405797
15,11.249428516950527,8.588522657527717,0.5522634802575642,2.1086423791652456,85,179,126,390,0,120,6,0.3230769230769231,0.45897435897435895
16,11.930809601325608,9.16351234206554,0.5743447141860508,2.1929525450740126,92,212,135,439,0,129,6,0.30751708428246016,0.48291571753986334
17,12.564523724333183,9.700082666780382,0.5945066345864322,2.269934422966377,104,238,147,489,0,143,4,0.3006134969325153,0.4867075664621677
18,13.173378461207141,10.217131927184546,0.6135606014009157,2.342685932621678,111,265,175,551,0,171,4,0.3176043557168784,0.4809437386569873
19,13.824589069035989,10.771702345599373,0.6336179992038261,2.41926872423279,125,302,187,614,0,185,2,0.30456026058631924,0.49185667752442996
20,14.543695701956969,11.385839214575668,0.6554041766263056,2.5024523107549856,143,331,213,687,0,211,2,0.31004366812227074,0.48180494905385735
21,15.18538842531123,11.935315246308928,0.6745434899816091,2.5755296890206907,151,369,245,765,0,245,0,0.3202614379084967,0.4823529411764706
22,16.093214911482605,12.714866705375687,0.7011666088146433,2.6771815972922743,186,404,262,852,0,262,0,0.3075117370892019,0.47417840375586856
23,16.944022902351644,13.447630057686037,0.7256664394588981,2.7707264052067018,197,469,269,935,0,269,0,0.2877005347593583,0.5016042780748663
24,17.82981026064276,14.21260058399529,0.7507416310023067,2.86646804564517,215,530,280,1025,0,280,0,0.2731707317073171,0.5170731707317073
25,18.49132621380651,14.785191143996709,0.769197844677509,2.936937225132305,232,594,300,1126,0,300,0,0.2664298401420959,0.5275310834813499
26,19.233667502044536,15.428995064130852,0.7896489965481244,3.015023441365565,259,642,325,1226,0,325,0,0.26508972267536707,0.5236541598694943
27,20.162799245301983,16.236563069453034,0.8148792063082719,3.1113569695406738,282,706,348,1336,0,348,0,0.26047904191616766,0.5284431137724551
28,20.943860206164995,16.916872010522372,0.835790002869228,3.191198192773415,300,790,357,1447,0,357,0,0.24671734623358674,0.5459571527297857
29,21.787897779594623,17.653431803648754,0.8580967119887669,3.2763692639571103,335,850,369,1554,0,369,0,0.23745173745173745,0.546975546975547
30,22.502411598961345,18.278041961998685,0.8767559623884743,3.347613674574174,339,939,394,1672,0,394,0,0.23564593301435408,0.5616028708133971
31,23.430374039646168,19.090650964176024,0.9006972420787058,3.439025833391421,369,1017,400,1786,0,400,0,0.22396416573348266,0.5694288913773796
32,24.241788151047896,19.8024423996877,0.9213736465087212,3.517972104851479,392,1108,416,1916,0,416,0,0.21711899791231734,0.5782881002087683
33,25.222323835747925,20.66406200462012,0.9460543423095406,3.6122074888182443,420,1198,417,2035,0,417,0,0.2049140049140049,0.5886977886977887
34,25.918072528285915,21.276366091609884,0.9633730340270996,3.678333402648928,424,1325,415,2164,0,415,0,0.19177449168207025,0.6122920517560074
35,26.67408268150753,21.94254614221154,0.9820170175897331,3.7495195217062536,436,1401,460,2297,0,460,0,0.2002612102742708,0.6099259904222899
36,27.403217152966253,22.58584455736016,0.9998320481446606,3.817540547461432,490,1471,480,2441,0,480,0,0.19664072101597707,0.602621876280213
37,28.41908871306324,23.48338249961705,1.0243918556209064,3.9113143578252805,527,1572,489,2588,0,489,0,0.18894899536321483,0.60741885625966
38,29.233348096220602,24.203808384240283,1.0438667326751565,3.9856729793051398,531,1710,491,2732,0,491,0,0.17972181551976574,0.6259150805270863
39,30.043587354952724,24.921538358626588,1.0630667728224013,4.058982223503713,552,1821,516,2889,0,516,0,0.1786085150571132,0.6303219106957425
40,30.66771588215954,25.474972945231972,1.0777391001170424,4.115003836810523,576,1906,579,3061,0,579,0,0.18915387128389416,0.622672329304149
41,31.575952910701055,26.28118599208824,1.098913888768691,4.1958530298440895,634,1995,595,3224,0,595,0,0.18455334987593053,0.6187965260545906
42,32.48469175265496,27.08881895573274,1.1198981276631048,4.27597466925913,648,2145,604,3397,0,604,0,0.17780394465705035,0.6314395054459817
43,33.225208212338266,27.747641481625127,1.1368534724121593,4.340713258300972,678,2280,614,3572,0,614,0,0.17189249720044794,0.6382978723404256
44,34.04346213544814,28.476328028758594,1.1554429278034868,4.411691178886042,728,2385,632,3745,0,632,0,0.16875834445927904,0.636849132176235
45,34.81864616946428,29.167318917632755,1.1729169767952128,4.478410275036268,737,2528,657,3922,0,657,0,0.16751657317695054,0.644569097399286
46,35.575196238933316,29.842300117579892,1.1898463648092081,4.543049756544246,777,2662,644,4083,0,644,0,0.15772716140093068,0.6519715895175117
47,36.15685817493237,30.361641742505384,1.2027807689942744,4.592435663432687,827,2767,639,4233,0,639,0,0.15095676824946846,0.653673517599811
48,36.70618670446102,30.85242037255614,1.2149326349236609,4.63883369698125,878,2852,633,4363,0,633,0,0.1450836580334632,0.6536786614714646
49,37.072624328927965,31.179963790939983,1.223005017318256,4.669655520669704,930,2945,584,4459,0,584,0,0.13097106974657996,0.6604619869925993
50,37.383116695102274,31.45760025731077,1.2298241663340808,4.695692271457401,946,3024,558,4528,0,558,0,0.12323321554770318,0.6678445229681979
51,37.57034959953216,31.62506438742397,1.2339271194941532,4.711358092614035,971,3088,509,4568,0,509,0,0.11142732049036777,0.6760070052539404
52,37.66450558652793,31.70929143403132,1.2359878429709976,4.7192263095256255,987,3112,488,4587,0,488,0,0.10638761717898408,0.6784390669282756
53,37.71206875021318,31.751842111122613,1.237028170377287,4.723198468713274,1031,3112,450,4593,0,450,0,0.09797517962116264,0.6775527977356848
54,37.71635703548112,31.75567857519965,1.2371219445867188,4.723556515694743,1031,3112,451,4594,0,451,0,0.09817152808010449,0.6774053112755768
55,37.716357035481124,31.755678575199628,1.2371219445867188,4.723556515694742,1031,3112,451,4594,0,451,0,0.09817152808010449,0.6774053112755768
56,37.716357035481124,31.755678575199656,1.2371219445867188,4.723556515694745,1031,3112,451,4594,0,451,0,0.09817152808010449,0.6774053112755768
57,37.71635703548111,31.755678575199646,1.237121944586718,4.7235565156947406,1031,3112,451,4594,0,451,0,0.09817152808010449,0.6774053112755768
58,37.71635703548115,31.755678575199642,1.237121944586718,4.723556515694743,1031,3112,451,4594,0,451,0,0.09817152808010449,0.6774053112755768
59,37.71627306508117,31.755603451902648,1.2371201083955405,4.723549504782976,1034,3112,448,4594,0,448,0,0.09751850239442751,0.6774053112755768
60,37.7190152940173,31.758056763592585,1.2371800723523014,4.723778458072423,1038,3112,444,4594,0,441,3,0.09664780148019156,0.6774053112755768
61,37.727726283321076,31.765850022194968,1.2373705447620205,4.724505716364078,1051,3112,431,4594,0,424,7,0.09381802350892468,0.6774053112755768
62,37.71996983562367,31.758910737728556,1.2372009448461623,4.723858153048983,1063,3119,412,4594,0,398,14,0.08968219416630388,0.6789290378754897
63,37.72091325241896,31.759754759961655,1.237221573906227,4.723936918551047,1077,3119,398,4594,0,365,33,0.08663474096647801,0.6789290378754897
64,37.719888736184295,31.758838182635422,1.2371991714912818,4.723851382057618,1124,3119,351,4594,0,307,44,0.07640400522420548,0.6789290378754897
65,37.72670012327677,31.76493196773675,1.237348107753589,4.724420047786431,1159,3119,316,4594,0,230,86,0.06878537222464083,0.6789290378754897
66,37.725236341069184,31.76362239614668,1.2373161017763656,4.724297843146122,1185,3119,290,4594,0,188,102,0.0631258162821071,0.6789290378754897
67,37.71955977515307,31.758543879822106,1.2371919782762328,4.723823917054707,1225,3119,250,4594,0,122,128,0.0544188071397475,0.6789290378754897
0,2.325140769936443,1.3949428361874383,0.19305994851394429,0.7371379852350601,0,0,25,25,0,6,19,1,0
1,2.562583436815169,1.570089460861634,0.20598931576394117,0.7865046601895938,11,0,19,30,0,5,14,0.6333333333333333,0
2,3.1606626826520943,2.0192010925849173,0.23690712246677256,0.9045544676004043,8,9,22,39,0,9,13,0.5641025641025641,0.23076923076923078
3,3.7272190212267593,2.4531318422596393,0.2644331880875153,1.0096539908796038,12,12,23,47,0,12,11,0.48936170212765956,0.2553191489361702
4,4.195443595547982,2.8167710495531644,0.2861395850177923,1.0925329609770251,10,21,25,56,0,15,10,0.44642857142857145,0.375
5,4.692947437246404,3.2073322530837003,0.3083352269016932,1.17727995726101,15,21,31,67,0,19,12,0.4626865671641791,0.31343283582089554
6,5.171750774562432,3.586732544145645,0.32896604782235184,1.2560521825944344,8,35,39,82,0,25,14,0.47560975609756095,0.4268292682926829
7,5.795545471200563,4.085508835950966,0.3549132639197276,1.355123371329869,20,35,46,101,0,35,11,0.45544554455445546,0.3465346534653465
8,6.485196184549217,4.642057779051117,0.38253815963168075,1.4606002458664173,26,42,55,123,0,42,13,0.44715447154471544,0.34146341463414637
9,7.263879806996212,5.27600832868125,0.4125770992729166,1.575294379042045,28,59,56,143,0,50,6,0.3916083916083916,0.4125874125874126
10,7.909559576606248,5.8055676420002404,0.436677571333322,1.6673143632726837,31,74,59,164,0,55,4,0.3597560975609756,0.45121951219512196
11,8.740414693474547,6.491547053442857,0.4667461139688413,1.7821215260628482,42,82,64,188,0,64,0,0.3404255319148936,0.43617021276595747
12,9.317862261733081,6.971004724421162,0.48708363981945474,1.8597738974924638,36,107,72,215,0,72,0,0.33488372093023255,0.49767441860465117
13,9.787587158647403,7.362505885613673,0.5033187547805854,1.9217625182531446,44,113,91,248,0,91,0,0.36693548387096775,0.45564516129032256
14,10.551021448227157,8.001420530137992,0.5291624546977511,2.020438463391413,48,132,102,282,0,102,0,0.3617021276595745,0.46808510638297873
15,11.043261400222757,8.414966426898669,0.5454951831427344,2.082799790181349,60,145,116,321,0,116,0,0.3613707165109034,0.4517133956386293
16,11.690939204055756,8.96085859083013,0.5666205046317346,2.163460108593895,72,161,128,361,0,128,0,0.3545706371191136,0.44598337950138506
17,12.096391844393569,9.303549412895853,0.5796465423863201,2.213195889111404,77,180,150,407,0,150,0,0.36855036855036855,0.44226044226044225
18,12.634900760420127,9.759773363584033,0.5967245540603205,2.2784028427757685,91,199,180,470,0,180,0,0.3829787234042553,0.42340425531914894
19,13.47112436790546,10.47049906817304,0.6227712886237077,2.3778540111087016,113,213,202,528,0,202,0,0.38257575757575757,0.4034090909090909
20,14.291360920683282,11.17013699193353,0.6478011927593823,2.4734227359903693,119,265,204,588,0,204,0,0.3469387755102041,0.45068027210884354
21,14.87186222702178,11.66667966022319,0.6652265704676307,2.5399559963309524,144,299,220,663,0,220,0,0.33182503770739064,0.45098039215686275
22,15.208438523293536,11.955077290291811,0.6752259162833764,2.5781353167183467,147,336,259,742,0,259,0,0.3490566037735849,0.4528301886792453
23,16.073168324836974,12.697626204747722,0.7005842136034305,2.6749579064858264,179,349,294,822,0,294,0,0.35766423357664234,0.4245742092457421
24,16.591517692460137,13.143787443018336,0.7155666555445258,2.7321635938972797,185,416,306,907,0,306,0,0.33737596471885334,0.45865490628445427
25,17.653691111681756,14.060340851833775,0.7457896765722222,2.847560583275756,200,457,343,1000,0,343,0,0.343,0.457
26,18.332390083969074,14.647522131957855,0.7647839145683668,2.9200840374428556,208,533,354,1095,0,354,0,0.3232876712328767,0.4867579908675799
27,19.261361349871393,15.453037649564385,0.7904068057240967,3.0179168945829145,236,591,365,1192,0,365,0,0.3062080536912752,0.49580536912751677
28,20.005327633384972,16.09956078229965,0.8106308558856337,3.095135995199691,258,668,364,1290,0,364,0,0.28217054263565894,0.517829457364341
29,20.935516301478927,16.909597728366844,0.835568005740242,3.1903505673718318,269,727,401,1397,0,401,0,0.2870436649964209,0.5204008589835362
30,21.615699036826765,17.503046117078696,0.8535694739099791,3.259083445838103,290,809,414,1513,0,414,0,0.2736285525446133,0.534699272967614
31,22.63616696705164,18.3950739721169,0.8802268480053198,3.3608661469294043,299,889,435,1623,0,435,0,0.2680221811460259,0.547751078250154
32,23.369713084339885,19.037483571729112,0.8991419743154462,3.43308753829534,318,982,449,1749,0,449,0,0.2567181246426529,0.5614636935391653
33,24.080189922380963,19.660594909123887,0.9172744367137312,3.502320576543337,353,1048,474,1875,0,474,0,0.2528,0.5589333333333333
34,25.083773516648595,20.5422198538185,0.9425866092666259,3.59896705356348,385,1128,481,1994,0,481,0,0.24122367101303913,0.5656970912738215
35,25.81655081964559,21.186973426486876,0.9608556853725634,3.6687217077861525,405,1238,475,2118,0,475,0,0.2242681775259679,0.5845136921624173
36,26.527931411200775,21.813693888755743,0.9784266556018012,3.735810866843241,432,1318,499,2249,0,499,0,0.2218763895064473,0.5860382392174299
37,27.404027596139258,22.586560019289017,0.9998517612330663,3.8176158156171627,462,1400,527,2389,0,527,0,0.22059439095856007,0.5860192549183759
38,28.291251160450273,23.370357587078427,1.0213175340960419,3.8995760392757965,474,1524,543,2541,0,543,0,0.21369539551357733,0.5997638724911453
39,28.941074154130508,23.94511398855806,1.0368973928546563,3.9590627727177776,481,1644,564,2689,0,564,0,0.2097433990330978,0.6113796950539234
40,29.74769930975816,24.6593358535944,1.056075434298134,4.032288021865602,532,1712,595,2839,0,595,0,0.20958083832335328,0.6030292356463544
41,30.68970455355602,25.494479791153747,1.078254195970285,4.116970566431996,565,1819,626,3010,0,626,0,0.2079734219269103,0.6043189368770764
42,31.584327476734504,26.28862441502757,1.0991081826184217,4.196594879088517,593,1949,640,3182,0,640,0,0.2011313639220616,0.6125078566939032
43,32.470713661524094,27.07638886373172,1.119576844824829,4.274747952967527,610,2100,643,3353,0,643,0,0.1917685654637638,0.6263048016701461
44,33.148468073296485,27.679338936299203,1.1351022737164154,4.334026863280858,636,2232,654,3522,0,654,0,0.18568994889267462,0.6337308347529813
45,33.96530177425453,28.406691984375644,1.1536737299748567,4.404936059904,666,2326,703,3695,0,703,0,0.19025710419485792,0.6294993234100136
46,34.79862367040247,29.149463160717875,1.1724672755949188,4.476693234089685,711,2455,694,3860,0,694,0,0.17979274611398963,0.6360103626943006
47,35.33813082962523,29.63073159793113,1.1845545575214167,4.522844674172682,752,2585,671,4008,0,671,0,0.16741516966067865,0.6449600798403193
48,35.78103007826339,30.026041991213624,1.194431489765044,4.560556597284712,776,2683,677,4136,0,677,0,0.16368471953578337,0.6486943907156673
49,36.3177594003373,30.50536287630551,1.206346448383958,4.606050075647838,806,2768,672,4246,0,672,0,0.15826660386245878,0.6519076778144136
50,36.667768647799534,30.81808754138992,1.2140847579340646,4.635596348475517,819,2873,653,4345,0,653,0,0.15028768699654776,0.6612197928653625
51,36.8993334829937,31.02505023081443,1.2191908636598408,4.6550923885193916,874,2927,606,4407,0,606,0,0.13750850918992513,0.664170637621965
52,37.119406003191635,31.221789236972086,1.224033668460658,4.673583097758875,889,2970,601,4460,0,601,0,0.13475336322869955,0.6659192825112108
53,37.26220459280125,31.349472061990657,1.2271709026210589,4.685561628189496,919,3016,563,4498,0,563,0,0.12516674077367718,0.6705202312138728
54,37.39690183096943,31.469928781441325,1.2301264819775313,4.696846567550574,923,3052,555,4530,0,555,0,0.12251655629139073,0.6737306843267108
55,37.51526594361582,31.575793260534745,1.2327207455451303,4.706751937535951,961,3083,513,4557,0,513,0,0.11257406188281764,0.6765415843756858
56,37.596742421192786,31.648673196548224,1.2345049334167946,4.713564291227763,999,3091,485,4575,0,485,0,0.10601092896174863,0.6756284153005464
57,37.66134865411147,31.706467272410617,1.2359187773341367,4.718962604366704,1007,3107,478,4592,0,478,0,0.10409407665505227,0.6766114982578397
58,37.70316301893936,31.743874757896133,1.2368334126693525,4.722454848373891,1034,3107,457,4598,0,457,0,0.09939103958242715,0.6757285776424532
59,37.705536974262934,31.745998567352053,1.236885329736208,4.722653077174613,1034,3107,458,4599,0,458,0,0.09958686671015438,0.6755816481843879
60,37.70553697426289,31.745998567352096,1.2368853297362083,4.72265307717461,1034,3107,458,4599,0,458,0,0.09958686671015438,0.6755816481843879
61,37.71092715849079,31.750820802375003,1.2370032059862877,4.723103150129462,1042,3107,450,4599,0,450,0,0.09784735812133072,0.6755816481843879
62,37.70506059446651,31.745572383714254,1.2368749116655553,4.722613299086664,1072,3107,420,4599,0,415,5,0.091324200913242,0.6755816481843879
63,37.71249447431154,31.752222979424193,1.237037480070958,4.723234014816383,1093,3107,399,4599,0,363,36,0.0867579908675799,0.6755816481843879
64,37.700153430773184,31.741182300364894,1.2367675931036035,4.722203537304674,1122,3107,370,4599,0,325,45,0.08045227223309415,0.6755816481843879
65,37.738001284734764,31.775042609995722,1.2375951966439498,4.72536347809508,1123,3107,369,4599,0,295,74,0.08023483365949119,0.6755816481843879
66,37.71425800814913,31.753800702896825,1.2370760444863274,4.723381260765976,1171,3115,313,4599,0,237,76,0.06805827353772559,0.6773211567732116
67,37.72067678459815,31.759543205352294,1.2372164032397035,4.7239171760061405,1181,3115,303,4599,0,192,111,0.06588388780169602,0.6773211567732116
68,37.703288936415646,31.743987407199654,1.2368361664410565,4.722465362774942,1209,3115,275,4599,0,150,125,0.05979560774081322,0.6773211567732116
69,37.71428563301521,31.753825417160524,1.2370766485736178,4.723383567281089,1209,3115,275,4599,0,129,146,0.05979560774081322,0.6773211567732116
0,2.325140769936443,1.3949428361874383,0.1930599485139443,0.7371379852350599,0,0,25,25,0,7,18,1,0
1,2.8489877542833506,1.7838569998570242,0.22106487356018106,0.8440658808661461,12,0,21,33,0,9,12,0.6363636363636364,0
2,3.4694859831280644,2.254831862628316,0.2520980250093819,0.962556095490367,9,9,27,45,0,12,15,0.6,0.2
3,4.072313717654241,2.7207494926941735,0.2805133297086929,1.0710508952513729,8,18,32,58,0,14,18,0.5517241379310345,0.3103448275862069
4,4.780132057888721,3.276173741824448,0.31214229201333976,1.1918160240509341,16,21,38,75,0,17,21,0.5066666666666667,0.28
5,5.431663055156831,3.793975368040413,0.33989744449586023,1.2977902426205572,18,32,41,91,0,22,19,0.45054945054945056,0.3516483516483517
6,5.889845170158348,4.161309065801363,0.3587527763759782,1.3697833279810074,22,42,40,104,0,26,14,0.38461538461538464,0.40384615384615385
7,6.383638723229156,4.559793122621504,0.3785339925789469,1.4453116080287058,25,50,47,122,0,33,14,0.38524590163934425,0.4098360655737705
8,6.870380174659252,4.954964446262718,0.3975391134407905,1.5178766149557448,26,60,57,143,0,41,16,0.3986013986013986,0.4195804195804196
9,7.249531385974366,5.264278546381244,0.41203360821744023,1.573219231375681,41,60,67,168,0,54,13,0.39880952380952384,0.35714285714285715
10,7.859651492891549,5.764519465440205,0.434838722678581,1.6602933047727635,41,75,79,195,0,67,12,0.40512820512820513,0.38461538461538464
11,8.371364326568752,6.186254022475876,0.45351345934003057,1.731596844752844,43,91,97,231,0,85,12,0.4199134199134199,0.3939393939393939
12,9.15780316557181,6.8378988501965345,0.48148957488920885,1.8384147404860698,49,110,112,271,0,102,10,0.4132841328413284,0.4059040590405904
13,10.042460299118263,7.575459527799088,0.5120190280096407,1.954981743309538,64,133,122,319,0,107,15,0.3824451410658307,0.4169278996865204
14,10.78826109083805,8.200583478031543,0.5370651649221068,2.050612447884408,73,165,127,365,0,111,16,0.34794520547945207,0.4520547945205479
15,11.27847162926928,8.612987891513868,0.5532136059492353,2.112270131806171,73,194,151,418,0,133,18,0.361244019138756,0.46411483253588515
16,11.892903786215186,9.131471023192148,0.5731275545896877,2.1883052084333534,82,219,174,475,0,158,16,0.3663157894736842,0.4610526315789474
17,12.651775139724064,9.774088419396378,0.5972557344076336,2.2804309859200544,112,239,183,534,0,167,16,0.34269662921348315,0.44756554307116103
18,13.55579066766243,10.542605839137815,0.6253779832786927,2.3878068452459162,133,273,193,599,0,175,18,0.32220367278797996,0.4557595993322204
19,14.143502496369404,11.043843983471078,0.6433253517336153,2.4563331611647126,131,329,204,664,0,186,18,0.3072289156626506,0.4954819277108434
20,14.969379884268996,11.750201253680707,0.6681314138956804,2.5510472166925973,167,352,217,736,0,201,16,0.29483695652173914,0.4782608695652174
21,15.767155671059639,12.434594678716474,0.6916636021844313,2.640897390158738,165,412,241,818,0,221,20,0.2946210268948655,0.5036674816625917
22,16.624598755273563,13.1722871803921,0.7165174966735122,2.735794078207955,185,463,255,903,0,233,22,0.2823920265780731,0.512735326688815
23,17.43523567387052,13.871590810545968,0.7396244055956612,2.8240204577288885,199,525,266,990,0,243,23,0.2686868686868687,0.5303030303030303
24,18.22093226870288,14.551015072519531,0.7616809275097517,2.9082362686735967,241,564,278,1083,0,248,30,0.2566943674976916,0.5207756232686981
25,18.923465394977963,15.159811752297587,0.7811356616883822,2.982517980992006,242,633,309,1184,0,276,33,0.2609797297297297,0.5346283783783784
26,19.748528227484535,15.876257679669822,0.8036787929426766,3.0685917548720383,275,695,319,1289,0,281,38,0.24747866563227308,0.5391776570985259
27,20.54996480139677,16.57362712852451,0.8252776302187724,3.151060042653498,280,762,356,1398,0,319,37,0.25464949928469244,0.5450643776824035
28,21.44319240533577,17.352449700564154,0.8490220708016579,3.241720633969968,311,840,360,1511,0,325,35,0.23825281270681667,0.5559232296492389
29,22.250895775607106,18.05806305496042,0.8702105646625194,3.322622155984165,334,923,370,1627,0,338,32,0.22741241548862937,0.5673017824216349
30,23.137490985793885,18.834008452254594,0.8931756201685319,3.41030691337076,351,1008,389,1748,0,356,33,0.2225400457665904,0.5766590389016019
31,23.92562847983929,19.52496553850507,0.9133451387674775,3.4873178025667335,392,1082,398,1872,0,364,34,0.2126068376068376,0.5779914529914529
32,24.638930357975767,20.15123084661726,0.9314093325461066,3.556290178812409,390,1174,438,2002,0,402,36,0.21878121878121878,0.5864135864135864
33,25.499723555140243,20.908100959322187,0.9529782746037437,3.6386443212142945,433,1253,448,2134,0,416,32,0.2099343955014058,0.5871602624179943
34,26.424852374993584,21.722834785267914,0.975890443150612,3.7261271465750623,474,1342,448,2264,0,417,31,0.1978798586572438,0.592756183745583
35,27.359850147323687,22.54756138707647,0.9987769125041379,3.813511847743074,494,1450,460,2404,0,427,33,0.1913477537437604,0.6031613976705491
36,28.12388575886492,23.222418721198505,1.017285611591146,3.8841814260752856,522,1566,457,2545,0,429,28,0.17956777996070727,0.6153241650294695
37,28.893250510634957,23.90279557422506,1.0357547981228077,3.954700138287084,549,1660,487,2696,0,458,29,0.1806379821958457,0.615727002967359
38,29.663249498576025,24.584520734970063,1.054075781125773,4.024652982480225,581,1754,528,2863,0,493,35,0.18442193503318197,0.6126440796367447
39,30.650759568445817,25.459930868071496,1.077341805738069,4.113486894636267,622,1857,545,3024,0,517,28,0.18022486772486773,0.6140873015873016
40,31.484267191619804,26.199754695616914,1.0967856123779565,4.187726883624919,658,1991,538,3187,0,515,23,0.16881079385001568,0.6247254471289614
41,32.335592908643285,26.956243486149173,1.1164687480648208,4.262880674429316,676,2123,560,3359,0,536,24,0.16671628460851443,0.6320333432569217
42,33.14040110727346,27.672159312812127,1.1349181082844222,4.333323686176884,709,2245,584,3538,0,559,25,0.16506500847936686,0.6345392877331826
43,33.91514913533348,28.362012531068004,1.1525377857909465,4.400598818474521,732,2366,621,3719,0,596,25,0.16698037106749125,0.6361925248722775
44,34.78645370050637,29.13861037167537,1.1721938984366325,4.475649430394413,769,2494,639,3902,0,608,31,0.16376217324449,0.6391594054331112
45,35.51685870097504,29.790231638825944,1.1885452393139673,4.538081822835148,807,2625,637,4069,0,607,30,0.15654952076677317,0.6451216515114279
46,36.21691140059546,30.4152798611381,1.2041122063024732,4.5975193331548985,858,2740,625,4223,0,596,29,0.14799905280606204,0.648827847501776
47,36.70482302352769,30.851201675700946,1.214902543888569,4.638718803938173,875,2871,603,4349,0,571,32,0.1386525638077719,0.6601517590250632
48,37.05077293938715,31.160428134832287,1.2225243933981764,4.6678204111566775,933,2935,588,4456,0,550,38,0.1319569120287253,0.6586624775583483
49,37.41040226375723,31.48200285921478,1.2304225179239003,4.69797688661853,942,3014,571,4527,0,531,40,0.12613209631102276,0.665783079301966
50,37.57217085691669,31.62669351090092,1.2339669963428914,4.7115103496728565,975,3078,512,4565,0,474,38,0.11215772179627602,0.6742606790799562
51,37.652070957222364,31.698167587108482,1.235715793797211,4.718187576316626,990,3101,489,4580,0,451,38,0.10676855895196506,0.6770742358078603
52,37.71263624684453,31.752349814339137,1.23704058033131,4.7232458521740925,1032,3101,450,4583,0,414,36,0.09818895919703251,0.6766310277111063
53,37.71715141217762,31.756389256866317,1.2371393152532943,4.723622840058034,1032,3101,451,4584,0,415,36,0.09838568935427575,0.6764834205933682
54,37.7171514121776,31.756389256866264,1.2371393152532946,4.723622840058034,1032,3101,451,4584,0,415,36,0.09838568935427575,0.6764834205933682
55,37.717151412177614,31.756389256866303,1.2371393152532943,4.723622840058035,1032,3101,451,4584,0,415,36,0.09838568935427575,0.6764834205933682
56,37.7171514121776,31.75638925686627,1.2371393152532941,4.723622840058034,1032,3101,451,4584,0,415,36,0.09838568935427575,0.6764834205933682
57,37.71715141217762,31.756389256866306,1.237139315253295,4.7236228400580345,1032,3101,451,4584,0,415,36,0.09838568935427575,0.6764834205933682
58,37.717151412177586,31.7563892568663,1.2371393152532946,4.7236228400580345,1032,3101,451,4584,0,415,36,0.09838568935427575,0.6764834205933682
59,37.71780781562083,31.75697650249831,1.2371536687612772,4.723677644361245,1036,3101,447,4584,0,411,36,0.0975130890052356,0.6764834205933682
0,0,0,0,0,0,0,1,1,0,0,1,1,0
1,0,0,0,0,0,0,1,1,0,0,1,1,0
2,0,0,0,0,0,0,1,1,0,0,1,1,0
3,0,0,0,0,0,0,1,1,0,0,1,1,0
4,0,0,0,0,0,0,1,1,0,0,1,1,0
5,0.7071067811865476,0.2864455024149747,0.08730705785825098,0.3333542209133219,0,0,2,2,0,0,2,1,0
6,2.121320343559643,1.2463096226025667,0.18160599868920446,0.6934047222678716,1,0,2,3,0,0,2,0.6666666666666666,0
7,3.2169892001050897,2.0620061657721966,0.23971345995588347,0.9152695743770096,1,1,2,4,0,0,2,0.5,0.25
8,3.605551275463989,2.3593438909719877,0.2586468156492833,0.987560568842718,1,2,1,4,0,0,1,0.25,0.5
9,3.605551275463989,2.3593438909719877,0.2586468156492833,0.987560568842718,1,2,2,5,0,0,2,0.4,0.4
10,3.8944128353091862,2.582503381870818,0.27228309410985,1.0396263593285182,1,2,3,6,0,0,3,0.5,0.3333333333333333
11,4.300198214020307,2.8986710509745466,0.29088299610383705,1.1106441669419234,2,2,4,8,0,0,4,0.5,0.25
12,4.072614103249921,2.7209834155920776,0.2805271238535148,1.071103563804329,1,3,5,9,0,0,5,0.5555555555555556,0.3333333333333333
13,4.451929460208096,3.0176248779572026,0.29768585669358166,1.1366187255573121,2,3,6,11,0,0,6,0.5454545454545454,0.2727272727272727
14,4.616341377503315,3.1469376140944867,0.3049705924056059,1.1644331710032225,5,3,4,12,0,0,4,0.3333333333333333,0.25
15,4.886432134241041,3.3602590716191463,0.31675289978944976,1.2094201628324444,6,3,4,13,0,0,4,0.3076923076923077,0.23076923076923078
16,5.41547594742265,3.781043569185223,0.33922181435116416,1.2952105638862632,6,5,2,13,0,0,2,0.15384615384615385,0.38461538461538464
17,5.743903072168841,4.044040005355193,0.3528017685839648,1.3470612982296837,5,7,2,14,0,0,2,0.14285714285714285,0.5
18,6.316769472175631,4.505682854803063,0.375885901718835,1.4352007156537336,5,7,4,16,0,0,4,0.25,0.4375
19,6.202669575328598,4.413458269306315,0.37134574275934196,1.4178655632629418,2,11,5,18,0,0,5,0.2777777777777778,0.6111111111111112
20,6.803864095203053,4.90083122508632,0.3949690862506427,1.5080637838660904,3,11,6,20,0,0,6,0.3,0.55
21,7.397495493825433,5.385320832393576,0.41762115614623474,1.5945535052856235,5,11,7,23,0,0,7,0.30434782608695654,0.4782608695652174
22,7.605845949164343,5.5560645261892105,0.42542633307031064,1.6243550899048222,5,13,7,25,0,0,7,0.28,0.52
23,8.2177726265466,6.059471933711394,0.44794920039975933,1.7103514924354446,7,13,6,26,0,0,6,0.23076923076923078,0.5
24,8.883258560452383,6.609955142073815,0.4718176906068722,1.8014857277716938,7,15,8,30,0,0,8,0.26666666666666666,0.5
25,9.119473242485197,6.806046747046517,0.48014512169482004,1.8332813737438582,5,18,11,34,0,0,11,0.3235294117647059,0.5294117647058824
26,9.335686206716522,6.985836786091982,0.48770459673339517,1.862144823891145,6,19,15,40,0,0,15,0.375,0.475
27,10.04678133659836,7.579072953919258,0.512165890744719,1.9555424919343813,10,19,16,45,0,0,16,0.35555555555555557,0.4222222222222222
28,10.986275447147658,8.367030034958947,0.5436169723410533,2.075628439847658,13,23,12,48,0,0,12,0.25,0.4791666666666667
29,11.198357892255313,8.545511532938226,0.5505907538205274,2.102255605496559,12,27,12,51,0,0,12,0.23529411764705882,0.5294117647058824
30,11.870082827386609,9.112183752228683,0.5723941476742874,2.1855049274836427,13,29,13,55,0,0,13,0.23636363636363636,0.5272727272727272
31,12.314996692756917,9.488606813567943,0.5866092202090326,2.2397806589799423,13,32,15,60,0,0,15,0.25,0.5333333333333333
32,12.741012159855584,9.8498097997701,0.6000608671875535,2.2911414928979315,14,36,15,65,0,0,15,0.23076923076923078,0.5538461538461539
33,13.338546649349098,10.357641131582644,0.6186785036873776,2.3622270140790778,18,36,17,71,0,0,17,0.23943661971830985,0.5070422535211268
34,13.751740504884372,10.70958799776231,0.6313901429875978,2.4107623641344644,16,41,20,77,0,0,20,0.2597402597402597,0.5324675324675324
35,14.228061527619689,11.116060780007954,0.6458869476175298,2.466113799994205,18,43,24,85,0,0,24,0.2823529411764706,0.5058823529411764
36,14.728605175654215,11.544038962133563,0.6609477046929662,2.523618508827689,21,45,29,95,0,0,29,0.30526315789473685,0.47368421052631576
37,15.195423576829475,11.943918697620353,0.6748406353075528,2.5766642439015643,25,50,27,102,0,0,27,0.2647058823529412,0.49019607843137253
38,15.545736486827833,12.244448556300242,0.6851729667132738,2.6161149638143177,30,52,27,109,0,0,27,0.24770642201834864,0.47706422018348627
39,15.826112266420084,12.485249028029987,0.6933867098545484,2.647476528535549,26,58,36,120,0,0,36,0.3,0.48333333333333334
40,16.351694798977363,12.937268695655028,0.708654474274446,2.7057716290478844,33,59,44,136,0,0,44,0.3235294117647059,0.4338235294117647
41,16.654188702407478,13.197781853259189,0.7173674592571928,2.7390393898911,37,65,48,150,0,0,48,0.32,0.43333333333333335
42,17.258753339036215,13.719197096606248,0.7346248805043348,2.804931361925642,41,69,52,162,0,0,52,0.32098765432098764,0.42592592592592593
43,18.37365303239237,14.683257831124033,0.7659310795085231,2.9244641217598155,45,80,51,176,0,0,51,0.2897727272727273,0.45454545454545453
44,18.93038731474238,15.165815935976854,0.781326135215485,2.983245243550034,44,94,54,192,0,0,54,0.28125,0.4895833333333333
45,19.727078562487286,15.857612407585094,0.803096749130642,3.066369405771541,48,104,60,212,0,0,60,0.2830188679245283,0.49056603773584906
46,20.231930029981015,16.296724566409704,0.8167407565902712,3.1184647069810354,49,118,61,228,0,0,61,0.2675438596491228,0.5175438596491229
47,20.568785804478917,16.59002064181851,0.825781448854047,3.152983713806361,56,126,62,244,0,0,62,0.2540983606557377,0.5163934426229508
48,20.892635019251774,16.872215730569057,0.8344266448209406,3.1859926438617725,59,133,71,263,0,0,71,0.26996197718631176,0.5057034220532319
49,21.348598140311736,17.269894870006826,0.8465233202519625,3.2321799500529473,66,136,82,284,0,0,82,0.2887323943661972,0.4788732394366197
50,21.476145069443948,17.38121249201989,0.8498916670125392,3.2450409104115128,62,149,99,310,0,0,99,0.3193548387096774,0.4806451612903226
51,22.421115880917913,18.206926790697665,0.8746430187249574,3.3395460714952927,81,149,105,335,0,0,105,0.31343283582089554,0.44477611940298506
52,22.85098958867409,18.583106201282245,0.8857871181379303,3.3820962692539163,83,173,106,362,0,0,106,0.292817679558011,0.47790055248618785
53,23.42565618471827,19.086515682706718,0.9005763306061714,3.438564171405381,90,184,121,395,0,0,121,0.30632911392405066,0.46582278481012657
54,23.4605828281488,19.117130416227866,0.9014712553043458,3.4419811566165928,92,199,138,429,0,0,138,0.32167832167832167,0.46386946386946387
55,24.643355857145334,20.155118992482173,0.9315208587036753,3.5567160059594873,101,204,157,462,0,0,157,0.3398268398268398,0.44155844155844154
56,25.157839107325696,20.607349852861823,0.9444411660208017,3.6060480884430617,109,241,146,496,0,0,146,0.29435483870967744,0.48588709677419356
57,26.46669978948117,21.75971931158677,0.976920476544117,3.7300600013502647,124,255,154,533,0,0,154,0.28893058161350843,0.47842401500938087
58,27.749346550046226,22.891493461371276,1.0082336599136714,3.8496194287612897,124,296,150,570,0,0,150,0.2631578947368421,0.519298245614035
59,28.63475366508016,23.674108414845183,1.0295678821242364,3.9310773681107185,123,344,143,610,0,0,143,0.23442622950819672,0.5639344262295082
60,29.30271915779248,24.265225820136855,1.045517485173808,3.9919758524818154,129,374,147,650,0,0,147,0.22615384615384615,0.5753846153846154
61,30.086694783044504,24.959747445995596,1.0640834095761853,4.062863927472708,133,396,162,691,0,0,162,0.23444283646888567,0.573082489146165
62,30.674152662482975,25.480683155274043,1.0778898977226077,4.115579609486322,139,420,175,734,0,0,175,0.23841961852861035,0.5722070844686649
63,31.425321983769415,26.147407364402987,1.0954162417552957,4.182498377611129,150,442,190,782,0,0,190,0.24296675191815856,0.5652173913043478
64,32.084834283523975,26.733331734599663,1.1106892082673083,4.240813340656996,158,471,200,829,0,0,200,0.24125452352231605,0.5681544028950543
65,32.91924108695999,27.475354370144885,1.1298632808484206,4.314023435966696,172,499,207,878,0,0,207,0.2357630979498861,0.5683371298405467
66,33.38129111735315,27.886583053754023,1.14041110753944,4.35429695605968,174,541,209,924,0,0,209,0.2261904761904762,0.5854978354978355
67,33.524553746109056,28.01413579822823,1.1436716495601715,4.366746298320656,183,562,228,973,0,0,228,0.2343268242548818,0.5775950668036999
68,33.94907464901998,28.392235439435098,1.1533062510459184,4.403532958538962,197,569,256,1022,0,0,256,0.25048923679060664,0.5567514677103719
69,33.992412034726826,28.43084480864842,1.1542875374879706,4.407279688590436,210,596,257,1063,0,0,257,0.24176857949200375,0.5606773283160865
70,34.048260549808155,28.48060333163967,1.1555514981104402,4.412105720058046,218,605,282,1105,0,0,282,0.25520361990950224,0.5475113122171946
71,34.04305897269439,28.475968818948257,1.1554338054944775,4.411656348251641,222,617,311,1150,0,0,311,0.27043478260869563,0.5365217391304348
72,34.218736608037226,28.632510414590616,1.1594054363757165,4.426820757070917,231,624,338,1193,0,0,338,0.28331936295054483,0.5230511316010059
73,33.97231719541525,28.412942023525616,1.1538325828450142,4.405542589044599,244,637,363,1244,0,0,363,0.29180064308681675,0.5120578778135049
74,33.826667794432225,28.28319379189634,1.1505323401489571,4.3929416623869235,246,646,399,1291,0,3,396,0.3090627420604183,0.5003872966692486
75,33.84458711367507,28.29915555282591,1.1509386258366212,4.394492935012553,255,658,425,1338,0,4,421,0.31763826606875933,0.49177877428998507
76,34.483581612341574,28.868568418838464,1.1653800967648005,4.449633096738331,275,671,430,1376,0,4,426,0.3125,0.4876453488372093
77,34.52979344401077,28.90976487581759,1.1664210235872607,4.453607544605905,309,707,397,1413,0,0,397,0.28096249115357397,0.5003538570417552
78,34.50705874913984,28.889497299856313,1.165908980039975,4.451652469243541,323,719,408,1450,0,0,408,0.2813793103448276,0.49586206896551727
79,34.812370818604656,29.16172261149191,1.172776042985665,4.477872164127086,332,736,418,1486,0,0,418,0.2812920592193809,0.4952893674293405
80,35.135741409407245,29.450154737555188,1.1800274224598617,4.505559249392199,340,779,397,1516,0,0,397,0.26187335092348285,0.5138522427440633
81,34.97430705780624,29.306149045145915,1.1764101535710085,4.491747859089305,344,810,394,1548,0,4,390,0.25452196382428943,0.5232558139534884
82,34.65747536298766,29.023601079698068,1.1692946625695382,4.464579620720055,358,822,404,1584,0,2,402,0.255050505050505,0.5189393939393939
83,34.57870060811558,28.953366576847074,1.1675221574330836,4.4578118738354116,370,830,416,1616,0,13,403,0.25742574257425743,0.5136138613861386
84,34.54980069806851,28.927601434706588,1.1668715452260583,4.455327718135858,384,849,418,1651,0,18,400,0.2531798909751666,0.5142337976983646
85,34.38062798139697,28.77679641898603,1.163059380877747,4.440772181533217,413,863,406,1682,0,18,388,0.2413793103448276,0.5130796670630202
86,34.02164646121065,28.456890956294643,1.1549492557372845,4.409806249178723,392,881,445,1718,0,32,413,0.2590221187427241,0.5128055878928988
87,34.146120683579774,28.567800345753714,1.1577645984167297,4.420555739409331,395,892,463,1750,0,25,438,0.26457142857142857,0.5097142857142857
88,33.57810114128806,28.061817044568823,1.144889152149274,4.371394944569955,414,913,458,1785,0,37,421,0.25658263305322127,0.511484593837535
89,33.677825280648925,28.150624649461896,1.1471548479822096,4.380045783204803,398,926,500,1824,0,43,457,0.2741228070175439,0.5076754385964912
90,32.62747900733159,27.21580597772743,1.1231774212386012,4.288495608365568,429,945,491,1865,0,47,444,0.26327077747989275,0.5067024128686327
91,33.15322350513159,27.683571318342214,1.1352108312204356,4.334441355568936,358,958,587,1903,0,61,526,0.3084603258013663,0.5034156594850236
92,33.87808238021656,28.32899262565648,1.1516978735879453,4.397391880972154,439,984,512,1935,0,53,459,0.26459948320413434,0.5085271317829457
93,34.43257615842775,28.823101193694697,1.1642306530578015,4.44524431167524,479,1016,472,1967,0,36,436,0.23995932892730046,0.5165226232841891
94,33.88045223738525,28.33110370397473,1.1517515824059605,4.39759695100458,555,1035,411,2001,0,46,365,0.20539730134932535,0.5172413793103449
95,34.610671349320704,28.981870474917176,1.1682416909139426,4.4605591834895995,506,1047,478,2031,0,40,438,0.23535204332840964,0.5155096011816839
96,33.8918547836828,28.34126122252311,1.1520099843916314,4.39858357676805,600,1070,397,2067,0,30,367,0.19206579583938074,0.5176584421867441
97,34.259897914672926,28.66919288265711,1.160335006644793,4.430370025371028,523,1077,502,2102,0,57,445,0.23882017126546146,0.5123691722169362
98,33.8145959852024,28.27244093693009,1.1502585949244424,4.39189645334787,611,1098,427,2136,0,47,380,0.1999063670411985,0.5140449438202247
99,33.93390192552031,28.378718503164016,1.1529625970928148,4.402220825263473,548,1109,512,2169,0,72,440,0.23605348086675887,0.5112955278930382
100,34.38164862540494,28.777706157732446,1.1630823989508974,4.440860068721608,628,1128,444,2200,0,36,408,0.2018181818181818,0.5127272727272727
101,34.21819964988201,28.632031895716583,1.1593933074682974,4.4267744466971335,613,1153,471,2237,0,46,425,0.21054984354045597,0.5154224407688869
102,34.025181518896346,28.460040545842467,1.1550292585583537,4.410111714495534,659,1164,448,2271,0,35,413,0.19726992514310876,0.512549537648613
103,34.12183846705805,28.54616303761963,1.1572156551664612,4.418459774271943,613,1181,514,2308,0,59,455,0.22270363951473138,0.5116984402079723
104,33.822226154244014,28.27923742279527,1.1504316235082332,4.392557107940527,667,1194,486,2347,0,50,436,0.20707285896889646,0.5087345547507456
105,34.38307585602249,28.778978304397672,1.163114586186285,4.440982965438541,625,1210,551,2386,0,58,493,0.23093042749371331,0.5071248952221291
106,34.338232119644616,28.73900834824295,1.1621030468946845,4.437120724506977,726,1232,468,2426,0,46,422,0.19291014014839242,0.5078318219291014
107,35.03103164247358,29.35674652135696,1.1776818175902402,4.4966033035263715,697,1250,515,2462,0,66,449,0.20917952883834282,0.5077173030056864
108,35.09079411928225,29.410057328112835,1.1790208434502603,4.501715947719176,767,1294,432,2493,0,44,388,0.17328519855595667,0.5190533493782591
109,35.64870336081495,29.907912905783245,1.1914848114216767,4.549305643610038,755,1314,448,2517,0,37,411,0.17798967024235202,0.5220500595947557
110,35.2913545749159,29.588992955299766,1.1835090153920254,4.518852604224095,789,1375,381,2545,0,39,342,0.14970530451866404,0.5402750491159135
111,35.483840165827324,29.76076285729443,1.1878084979973933,4.535268810535502,730,1383,460,2573,0,57,403,0.17877963466770308,0.5375048581422464
112,35.390182957472454,29.67718053581836,1.1857174837395321,4.527284937914577,816,1394,391,2601,0,38,353,0.1503267973856209,0.5359477124183006
113,35.159782955258144,29.47160301316172,1.1805656483596336,4.507614293736783,760,1408,465,2633,0,38,427,0.17660463349791114,0.53475123433346
114,35.32173818283622,29.616104119292768,1.1841882018675083,4.521445861675941,800,1417,440,2657,0,49,391,0.16560030109145654,0.5333082423786225
115,35.072838028329926,29.394039305350535,1.1786186028825214,4.5001801200969025,779,1432,480,2691,0,53,427,0.17837235228539577,0.5321441843180974
116,34.9531373061976,29.28726679381569,1.1759353893622908,4.489935123019655,805,1436,483,2724,0,53,430,0.17731277533039647,0.527165932452276
117,34.88789005816371,29.229072752779274,1.1744715162118664,4.484345789172581,781,1456,525,2762,0,61,464,0.19007965242577843,0.5271542360608255
118,34.74864356828419,29.104893488090067,1.1713443562667039,4.472405723927414,828,1469,498,2795,0,48,450,0.178175313059034,0.5255813953488372
119,34.54978732609607,28.92758951339181,1.1668712441461706,4.4553265685581085,785,1493,554,2832,0,64,490,0.19562146892655366,0.5271892655367232
120,34.42581265552689,28.817072284727924,1.1640781901658221,4.444662180633139,825,1504,540,2869,0,63,477,0.18821889159986058,0.524224468455908
121,34.969658206319956,29.302002486357935,1.1763059041430617,4.491349815818964,801,1527,571,2899,0,68,503,0.19696447050707142,0.5267333563297689
122,34.631170787955924,29.00014755714756,1.1687029346960782,4.462320296112298,877,1550,503,2930,0,47,456,0.17167235494880545,0.5290102389078498
123,35.279048579290915,29.578012634982024,1.183233875233925,4.517802069074985,830,1563,564,2957,0,66,498,0.19073385187690226,0.528576259722692
124,35.10613399391263,29.423741774405997,1.1793644229164701,4.50302779659016,946,1586,455,2987,0,44,411,0.15232674924673587,0.530967525945765
125,35.32379649674028,29.617940777969352,1.1842342057826445,4.521621512988277,862,1600,557,3019,0,76,481,0.18449817820470354,0.5299768135144087
126,35.5492871419236,29.81917483649901,1.189268591691898,4.540843713732703,980,1621,447,3048,0,44,403,0.1466535433070866,0.5318241469816273
127,35.881725810389824,30.11594557512067,1.1966713695841613,4.569108865684982,949,1641,489,3079,0,64,425,0.1588177979863592,0.5329652484572913
128,35.74794311108575,29.996503356023766,1.1936950435034344,4.557744711558566,983,1701,426,3110,0,50,376,0.1369774919614148,0.5469453376205787
129,35.30150904744889,29.598053643464368,1.1837360272420707,4.51971937674245,949,1711,485,3145,0,64,421,0.15421303656597773,0.5440381558028616
130,34.89968405214846,29.239591494378512,1.1747361912352772,4.485356366534694,941,1719,523,3183,0,59,464,0.16431039899465913,0.5400565504241281
131,35.10887316966528,29.42618537278021,1.1794257691648269,4.503262027720244,895,1734,589,3218,0,68,521,0.18303293971410814,0.5388440024860162
132,34.80036709715844,29.151017905388077,1.172506436027814,4.47684275574256,951,1753,547,3251,0,69,478,0.16825592125499847,0.5392187019378653
133,35.099417580757844,29.41775014457847,1.1792139961881734,4.502453439991208,921,1770,594,3285,0,73,521,0.18082191780821918,0.5388127853881278
134,35.144437070832375,29.457912362750015,1.1802221092246403,4.506302598857717,978,1792,544,3314,0,61,483,0.16415208207604104,0.5407362703681352
0,2.3251407699364424,1.3949428361874383,0.19305994851394429,0.73713798523506,0,0,25,25,0,3,22,1,0
1,2.5925681479828295,1.5923470977472054,0.20759304816211074,0.7926280020735138,11,0,20,31,0,2,18,0.6451612903225806,0
2,3.1589177819306413,2.017876340138133,0.23681992188146395,0.9042215199110442,10,9,19,38,0,3,16,0.5,0.23684210526315788
3,3.5696675119680106,2.3317423777507362,0.2569278580450946,0.9809972761721794,9,13,27,49,0,6,21,0.5510204081632653,0.2653061224489796
4,4.091601794341157,2.735773238662392,0.2813983794804984,1.0744301761982664,10,21,28,59,0,8,20,0.4745762711864407,0.3559322033898305
5,4.675464022590908,3.1935408721590792,0.307568955750002,1.174354194681826,18,21,32,71,0,12,20,0.4507042253521127,0.29577464788732394
6,5.340680656611457,3.721332331299337,0.33609116185723215,1.2832571634548862,13,36,37,86,0,16,21,0.43023255813953487,0.4186046511627907
7,5.940585390439297,4.202136082337608,0.3608102337569541,1.3776390743447338,18,42,44,104,0,22,22,0.4230769230769231,0.40384615384615385
8,6.760570981441765,4.865619385765264,0.39329184061210426,1.5016597550643982,24,51,42,117,0,22,20,0.358974358974359,0.4358974358974359
9,7.433190086873066,5.414547820445291,0.4189634892585943,1.599678777169178,28,62,45,135,0,29,16,0.3333333333333333,0.45925925925925926
10,7.79834691157223,5.714123658297924,0.4325746374720257,1.6516486158022798,23,78,50,151,0,36,14,0.33112582781456956,0.5165562913907285
11,8.228630411665979,6.068429024748096,0.44834368407729686,1.7118577028405875,37,79,54,170,0,41,13,0.3176470588235294,0.4647058823529412
12,8.681464074853226,6.442719647208943,0.46464506988843546,1.7740993577558448,38,85,75,198,0,62,13,0.3787878787878788,0.4292929292929293
13,9.106380618566817,6.795168876428622,0.4796854559154749,1.8315262862227215,44,98,88,230,0,73,15,0.3826086956521739,0.4260869565217391
14,9.662867359020808,7.258431396449756,0.49903387902418017,1.9054020835468692,59,104,102,265,0,88,14,0.3849056603773585,0.39245283018867927
15,10.218286897801283,7.722574147930688,0.5179781178976707,1.977734631972925,62,122,118,302,0,101,17,0.39072847682119205,0.40397350993377484
16,10.881509684057274,8.278942367592693,0.5401554807756682,2.0624118356889145,79,140,116,335,0,104,12,0.34626865671641793,0.417910447761194
17,11.445594217712355,8.753843942708901,0.5586651514158111,2.133085123587642,75,175,128,378,0,114,14,0.3386243386243386,0.46296296296296297
18,12.252779343826834,9.43591708336232,0.5846317899077292,2.232230470556785,85,191,148,424,0,127,21,0.3490566037735849,0.45047169811320753
19,13.058222156619857,10.119229022357022,0.6099797071111546,2.32901342715168,97,227,148,472,0,133,15,0.3135593220338983,0.4809322033898305
20,13.937213213560328,10.867768380326524,0.6370545880296576,2.4323902452041475,102,262,166,530,0,151,15,0.3132075471698113,0.49433962264150944
21,14.671961250033572,11.495565176663957,0.6592520152276536,2.5171440581419504,110,300,177,587,0,158,19,0.30153321976149916,0.5110732538330494
22,15.26548826272113,12.003996124217036,0.6769134627083964,2.5845786757956946,115,338,190,643,0,172,18,0.2954898911353033,0.5256609642301711
23,16.28763484689879,12.882132223802756,0.7068024312086124,2.698700191887429,148,356,193,697,0,181,12,0.2769010043041607,0.5107604017216643
24,17.21769562106434,13.683755225878038,0.733459327302815,2.800481067883477,149,412,194,755,0,184,10,0.25695364238410595,0.5456953642384106
25,18.00190827899543,14.361459714422246,0.7555647964208493,2.884883768152334,148,468,203,819,0,195,8,0.24786324786324787,0.5714285714285714
26,18.409067501158297,14.713931764192088,0.7669149642760072,2.928220772690209,151,515,217,883,0,208,9,0.24575311438278596,0.5832389580973952
27,18.637546785032583,14.91189981071245,0.7732474852362525,2.9523994890838745,168,526,260,954,0,249,11,0.27253668763102723,0.5513626834381551
28,19.39331466749328,15.56761770853874,0.7940125763867889,3.0316843825677404,185,543,304,1032,0,296,8,0.29457364341085274,0.5261627906976745
29,20.25239109948026,16.314532900135298,0.8172913243923525,3.1205668749526208,205,591,315,1111,0,309,6,0.28352835283528355,0.531953195319532
30,21.262037015019356,17.194366355559723,0.8442335330953975,3.2234371263642454,221,657,312,1190,0,308,4,0.26218487394957984,0.5521008403361345
31,21.995303640443378,17.834640928456178,0.8635337704124413,3.297128941574775,232,723,320,1275,0,317,3,0.25098039215686274,0.5670588235294117
32,22.82857729959442,18.563485000054435,0.8852078357535796,3.3798844637863934,246,777,343,1366,0,339,4,0.25109809663250365,0.568814055636896
33,23.588414096004843,19.229198335238102,0.9047428937440372,3.454472867022687,254,840,371,1465,0,367,4,0.25324232081911263,0.5733788395904437
34,24.19847184915911,19.764415953818474,0.920275751863155,3.513780143477501,276,901,387,1564,0,383,4,0.24744245524296676,0.5760869565217391
35,24.876931927930897,20.36037923389587,0.9373977289506635,3.5791549650843515,296,951,425,1672,0,421,4,0.2541866028708134,0.56877990430622
36,25.322979648440654,20.752598634773964,0.9485696443459164,3.6218113693207723,304,1015,469,1788,0,465,4,0.26230425055928414,0.5676733780760627
37,26.03556252966024,21.379839029637278,0.9662822358538204,3.689441264169132,335,1060,518,1913,0,514,4,0.2707788813382122,0.5541035023523262
38,26.62858629938636,21.902431489322016,0.9809000549190179,3.745254755145341,356,1129,557,2042,0,551,6,0.272771792360431,0.5528893241919687
39,26.740989452324087,22.001544121592957,0.9836584648687227,3.755786865862394,387,1182,609,2178,0,601,8,0.2796143250688705,0.5426997245179064
40,27.936193702729536,23.05655846914524,1.0127544824420247,3.8668807511422774,402,1220,691,2313,0,683,8,0.29874621703415477,0.527453523562473
41,28.622920203964433,23.66364172287136,1.0292842130570434,3.929994268035983,406,1356,704,2466,0,694,10,0.28548256285482565,0.5498783454987834
0,4.080528299910217,2.7271471215783287,0.28089043323869417,1.0724907450931958,0,0,69,69,0,16,53,1,0
1,4.56390882853878,3.105652590180121,0.30265695513104246,1.1555992832276167,45,0,36,81,0,11,25,0.4444444444444444,0
2,5.099733819726449,3.5294642710650237,0.3259050006655788,1.2443645479958465,28,29,36,93,0,16,20,0.3870967741935484,0.3118279569892473
3,5.57503815265506,3.9086566654258657,0.34585276150039906,1.3205287257287963,29,37,44,110,0,23,21,0.4,0.33636363636363636
4,6.269980331488956,4.467848095537137,0.3740274451975468,1.4281047907542697,35,45,52,132,0,32,20,0.3939393939393939,0.3409090909090909
5,6.9286976934452635,5.00245822051907,0.39978555098468244,1.526453921941515,36,61,57,154,0,38,19,0.37012987012987014,0.3961038961038961
6,7.521471649949405,5.486877686969329,0.42227421873171345,1.6123197442483603,35,79,69,183,0,47,22,0.3770491803278688,0.43169398907103823
7,8.37785099127957,6.191612058090323,0.45374770311474955,1.7324912300744981,46,93,71,210,0,52,19,0.3380952380952381,0.44285714285714284
8,8.990692628172857,6.699097080252303,0.47561417032313347,1.8159813775974183,45,114,87,246,0,70,17,0.35365853658536583,0.4634146341463415
9,9.534571329243786,7.151465562035012,0.4946068573452176,1.8884989098635572,55,127,101,283,0,87,14,0.3568904593639576,0.44876325088339225
10,10.152257592038564,7.667307779188832,0.5157443007801332,1.9692055120695995,64,143,117,324,0,104,13,0.3611111111111111,0.44135802469135804
11,10.74164473666169,8.161426783645608,0.5355169336448472,2.0447010193712343,75,165,129,369,0,115,14,0.34959349593495936,0.44715447154471544
12,11.403756436082709,8.718569710277466,0.5573029053558043,2.1278838204494344,84,187,157,428,0,144,13,0.36682242990654207,0.4369158878504673
13,12.07300038135476,9.283759560674065,0.5788990382544855,2.2103417824262173,102,212,171,485,0,159,12,0.3525773195876289,0.43711340206185567
14,12.681665460884785,9.799448090595996,0.5981960579844644,2.2840213123043203,118,244,180,542,0,169,11,0.33210332103321033,0.45018450184501846
15,13.405931065754498,10.414994578461462,0.6207604030230826,2.370176084269951,141,264,208,613,0,197,11,0.33931484502446985,0.43066884176182707
16,14.172128046184318,11.068288601647097,0.6441930922624428,2.4596463522747816,145,313,228,686,0,219,9,0.3323615160349854,0.45626822157434405
17,15.00235974138176,11.778454613276661,0.669112385078416,2.554792743026678,165,359,235,759,0,225,10,0.3096179183135705,0.47299077733860345
18,15.734777788672377,12.406780639172142,0.6907163895189173,2.6372807599813206,177,414,254,845,0,244,10,0.3005917159763314,0.48994082840236686
19,16.579014071071846,13.13301621408567,0.7152071023933564,2.730790754592817,195,465,267,927,0,258,9,0.28802588996763756,0.5016181229773463
20,17.540164146361302,13.962235803399622,0.7425889013694075,2.835339441592283,221,520,268,1009,0,263,5,0.26560951437066405,0.5153617443012884
21,18.371564079453353,14.681448597845666,0.7658730244846143,2.9242424571230723,238,587,272,1097,0,266,6,0.2479489516864175,0.5350957155879672
22,19.27815956891783,15.467621980074744,0.7908662920240381,3.0196712968190536,254,652,285,1191,0,281,4,0.23929471032745592,0.5474391267842149
23,20.011286950204003,16.104744487505606,0.8107918318807996,3.0957506308175984,283,723,282,1288,0,274,8,0.21894409937888198,0.5613354037267081
24,20.64672369174091,16.657914149219327,0.8278661314667449,3.160943411054844,295,777,318,1390,0,309,9,0.22877697841726619,0.5589928057553957
25,21.26559112349662,17.19746718228638,0.8443276104398599,3.223796330770376,304,843,352,1499,0,338,14,0.23482321547698465,0.5623749166110741
26,22.10576600475458,17.931184781957604,0.8664225179389946,3.308158704857979,342,895,370,1607,0,362,8,0.23024268823895458,0.5569383945239577
27,22.911239549366595,18.635857524193966,0.8873434391867737,3.3880385859858633,373,974,376,1723,0,367,9,0.21822402785838654,0.5652930934416716
28,23.80855735218475,19.422261477209403,0.9103632948062053,3.475932580169147,387,1062,398,1847,0,386,12,0.21548456957227938,0.5749864645370871
29,24.653298644085403,20.163854622873934,0.9317714006287966,3.5576726205826774,387,1169,421,1977,0,411,10,0.21294891249367728,0.5912999494183105
30,25.51519380901639,20.921714294068373,0.9533636729137399,3.6401158420342763,419,1248,444,2111,0,434,10,0.21032685930838466,0.591189009947892
31,26.3469777306899,21.654202653251993,0.9739721858833378,3.7188028915545623,449,1340,461,2250,0,451,10,0.2048888888888889,0.5955555555555555
32,27.191375954873322,22.398862663704108,0.9946725698653138,3.7978407213039254,471,1444,478,2393,0,470,8,0.1997492687003761,0.60342666109486
33,27.95193013040139,23.070462606648118,1.013134769080871,3.868332754672418,499,1543,496,2538,0,490,6,0.1954294720252167,0.6079590228526399
34,28.81361585231388,23.832334822080334,1.0338507798597922,3.947430250373751,540,1632,517,2689,0,509,8,0.19226478244700632,0.6069170695425808
35,29.64233334112336,24.565992267786147,1.0535802227681048,4.022760850569125,569,1739,540,2848,0,528,12,0.1896067415730337,0.6106039325842697
36,30.526806434040513,25.34998182247812,1.074435296739355,4.102389314822994,587,1855,585,3027,0,575,10,0.19326065411298315,0.6128179715890321
37,31.464153516747025,26.18189192881568,1.0963184427781978,4.185943145153116,632,1982,588,3202,0,576,12,0.18363522798251092,0.6189881324172393
38,32.272366694840755,26.900031768373754,1.1150129092667251,4.257322017200223,657,2115,609,3381,0,601,8,0.18012422360248448,0.6255545696539485
39,33.15364872975819,27.68394977374414,1.1352205380406464,4.334478417973374,725,2217,622,3564,0,612,10,0.1745230078563412,0.6220538720538721
40,34.020052061541826,28.4554704167915,1.1549131715519543,4.409668473198368,731,2369,648,3748,0,638,10,0.1728922091782284,0.6320704375667022
41,34.85320387147784,29.198137921882726,1.173692932934835,4.48137301666028,748,2513,671,3932,0,663,8,0.17065106815869788,0.6391149542217701
42,35.63659686680509,29.89710622117474,1.1912150396591363,4.54827560597125,784,2656,668,4108,0,664,4,0.1626095423563778,0.6465433300876339
43,36.31341776238229,30.5014844795599,1.2062503039820058,4.6056829788403855,838,2766,657,4261,0,655,2,0.1541891574747712,0.6491433935695846
44,36.79525019988202,30.932018682787337,1.2168971073215327,4.646334409773124,848,2898,629,4375,0,629,0,0.14377142857142858,0.6624
45,37.092733946594336,31.197942664027774,1.223447247325138,4.671344035241436,913,2961,580,4454,0,580,0,0.13022002694207455,0.6647956892680736
46,37.22945486885314,31.32018730988069,1.2264517575225837,4.682815801449864,918,3024,562,4504,0,562,0,0.12477797513321492,0.6714031971580817
47,37.42140731343309,31.491845324374374,1.23066380904993,4.698898180008824,928,3049,562,4539,0,562,0,0.12381581846221634,0.6717338620841595
48,37.55137394865426,31.608090761308,1.2335116049209247,4.709771582425348,968,3088,504,4560,0,504,0,0.11052631578947368,0.6771929824561403
49,37.641410661527125,31.688631149309238,1.2354825402716378,4.71729697194625,995,3096,490,4581,0,490,0,0.10696354507749399,0.6758349705304518
50,37.70295465900402,31.74368835329046,1.236828855902818,4.7224374498107595,1029,3112,449,4590,0,449,0,0.09782135076252724,0.677995642701525
51,37.7148551117513,31.75433489481654,1.2370891016279717,4.723431115306799,1030,3112,451,4593,0,451,0,0.098192902242543,0.6775527977356848
52,37.71697331477618,31.75622992364415,1.2371354208009944,4.723607970331066,1030,3112,452,4594,0,452,0,0.09838920330866348,0.6774053112755768
53,37.7169733147762,31.756229923644142,1.237135420800994,4.723607970331069,1030,3112,452,4594,0,452,0,0.09838920330866348,0.6774053112755768
54,37.71697331477619,31.756229923644113,1.2371354208009944,4.723607970331067,1030,3112,452,4594,0,452,0,0.09838920330866348,0.6774053112755768
55,37.716973314776226,31.756229923644142,1.2371354208009941,4.723607970331071,1030,3112,452,4594,0,452,0,0.09838920330866348,0.6774053112755768
56,37.71697331477619,31.75622992364415,1.2371354208009946,4.723607970331067,1030,3112,452,4594,0,452,0,0.09838920330866348,0.6774053112755768
57,37.71433560534725,31.753870124325324,1.2370777413441747,4.723387739677759,1035,3112,447,4594,0,447,0,0.09730082716586852,0.6774053112755768
58,37.71054361512271,31.750477671045093,1.2369948185821422,4.72307112549545,1048,3112,434,4594,0,431,3,0.09447104919460166,0.6774053112755768
59,37.72988823903383,31.76778421987031,1.2374178152980915,4.7246862038654385,1092,3112,390,4594,0,375,15,0.08489333913800609,0.6774053112755768
60,37.701605957666395,31.74248176846028,1.2367993600239078,4.7223248291821935,1135,3120,339,4594,0,287,52,0.07379190248149761,0.6791467131040487
61,37.750264185104015,31.786013811352372,1.2378632851182714,4.7263870886334,1174,3120,300,4594,0,210,90,0.06530256856769699,0.6791467131040487
0,4.080528299910218,2.7271471215783274,0.28089043323869417,1.072490745093196,0,0,69,69,0,7,62,1,0
1,4.612823364741096,3.1441662298230932,0.3048156317754348,1.1638415031425688,45,0,36,81,0,8,28,0.4444444444444444,0
2,5.1650044651555875,3.5813649231780933,0.3286799049387253,1.254959637038769,27,29,40,96,0,12,28,0.4166666666666667,0.3020833333333333
3,5.732578250097281,4.03495024632092,0.35233788757622614,1.345290116200136,31,37,41,109,0,19,22,0.3761467889908257,0.3394495412844037
4,6.232234362716477,4.4373420922268565,0.37252481085633615,1.422367459633283,28,49,51,128,0,31,20,0.3984375,0.3828125
5,6.888544889885616,4.969754513922341,0.39823951199237767,1.5205508639708964,31,61,57,149,0,40,17,0.3825503355704698,0.40939597315436244
6,7.564383722615211,5.522058485945516,0.4238788227050319,1.618446413964667,42,69,64,175,0,52,12,0.3657142857142857,0.3942857142857143
7,8.273963201810872,6.1058351609208765,0.44998883867528217,1.718139202214714,38,91,78,207,0,66,12,0.37681159420289856,0.4396135265700483
8,8.871468872270823,6.600177288489176,0.4714001400301534,1.7998914437514955,40,111,93,244,0,81,12,0.38114754098360654,0.45491803278688525
9,9.421241523817734,7.057057410664568,0.49067972159782697,1.8735043915553389,53,124,109,286,0,93,16,0.3811188811188811,0.43356643356643354
10,10.225504161272696,7.728616387516231,0.5182219907796435,1.9786657829768204,71,133,122,326,0,109,13,0.37423312883435583,0.40797546012269936
11,10.834004331395313,8.239017213892417,0.5385822319345631,2.056404885568331,74,166,133,373,0,118,15,0.35656836461126007,0.4450402144772118
12,11.630328273384595,8.90969178520942,0.5646604032061684,2.155976084969007,87,191,150,428,0,134,16,0.35046728971962615,0.4462616822429907
13,12.454668009325447,9.606947870114617,0.5910362553079077,2.256683883902921,106,218,159,483,0,143,16,0.32919254658385094,0.45134575569358176
14,13.031398673046684,10.09643166358639,0.6091440963030789,2.3258229131572117,103,264,181,548,0,163,18,0.3302919708029197,0.48175182481751827
15,13.94851913082047,10.877414558841345,0.6373990621088756,2.4337055098702507,128,290,196,614,0,180,16,0.31921824104234525,0.4723127035830619
16,14.700525979626393,11.520008508641347,0.6601073996384064,2.5204100713466424,137,337,211,685,0,199,12,0.30802919708029197,0.491970802919708
17,15.184229868338114,11.93432199924736,0.6745091803773275,2.5753986887134332,151,379,230,760,0,214,16,0.3026315789473684,0.4986842105263158
18,16.038308751637743,12.667648993265306,0.699570893247114,2.6710888651253444,189,397,249,835,0,240,9,0.29820359281437125,0.4754491017964072
19,17.10073016874737,13.58281276010604,0.7301338017934835,2.7877836068478445,199,462,255,916,0,249,6,0.27838427947598254,0.5043668122270742
20,17.85719591970597,14.236283293582405,0.751510167686022,2.869402458437538,199,540,262,1001,0,257,5,0.26173826173826176,0.5394605394605395
21,18.55235832414014,14.83807280238737,0.7708894479109484,2.943396073841803,211,598,280,1089,0,272,8,0.2571166207529844,0.549127640036731
22,19.329516264840105,15.51221420474788,0.7922702388870687,3.025031821205172,235,639,305,1179,0,297,8,0.2586938083121289,0.5419847328244275
23,20.140140044781784,16.216845988342627,0.8142685777515272,3.1090254786876512,263,700,315,1278,0,307,8,0.24647887323943662,0.5477308294209703
24,21.020271581832585,16.98349464933984,0.8378216274984953,3.198955304994256,282,774,327,1383,0,319,8,0.23644251626898047,0.559652928416486
25,21.813638536314716,17.675916828232616,0.85877242997931,3.2789492781028193,310,830,347,1487,0,339,8,0.23335574983187626,0.5581708137188971
26,22.59183870148677,18.3562843860253,0.879077310756155,3.356477004705321,319,907,373,1599,0,367,6,0.233270794246404,0.5672295184490307
27,23.272113591724743,18.951954353042893,0.8966368231226475,3.4235224155592,335,982,401,1718,0,391,10,0.23341094295692666,0.5715948777648429
28,24.07007275375209,19.651715740687834,0.9170174932774875,3.5013395197867725,367,1047,432,1846,0,422,10,0.23401950162513543,0.5671722643553629
29,24.882125906693453,20.364944569689147,0.9375282020197587,3.5796531349845333,388,1135,452,1975,0,440,12,0.22886075949367088,0.5746835443037974
30,25.750818276578293,21.129102588919267,0.9592240106462149,3.662491677012818,391,1230,477,2098,0,467,10,0.22735938989513824,0.5862726406101049
31,26.537771399151698,21.82236818277217,0.978668592078769,3.736734624300753,419,1330,475,2224,0,465,10,0.2135791366906475,0.5980215827338129
32,27.41930877961115,22.600050474114674,1.0002234218954926,3.8190348836009713,461,1410,494,2365,0,486,8,0.20887949260042282,0.5961945031712473
33,28.30535288899562,23.38282424379088,1.0216568886274011,3.9008717565773474,470,1528,514,2512,0,506,8,0.20461783439490447,0.60828025477707
34,29.049817436638882,24.041350537483503,1.0394931300133876,3.968973769142024,476,1637,559,2672,0,545,14,0.2092065868263473,0.6126497005988024
35,30.016258963740064,24.89731653359189,1.0624220138043399,4.0565204163438375,537,1710,576,2823,0,564,12,0.20403825717321997,0.6057385759829969
36,30.924896428767497,25.70316290030327,1.0837560153416297,4.137977513122584,562,1843,570,2975,0,564,6,0.1915966386554622,0.6194957983193278
37,31.71687790977687,26.40636881979508,1.1021811318830068,4.208327958098755,570,1981,594,3145,0,586,8,0.1888712241653418,0.6298887122416534
38,32.55067262683733,27.147495794872363,1.1214140594644282,4.2817627725005405,615,2091,605,3311,0,601,4,0.18272425249169436,0.6315312594382362
39,33.36355956356225,27.870797467017542,1.140007227584747,4.352754868959943,658,2204,610,3472,0,610,0,0.17569124423963134,0.6347926267281107
40,34.034145333120016,28.468026991785564,1.155232108578843,4.410886232755582,667,2328,642,3637,0,642,0,0.17651910915589772,0.6400879846026946
41,34.79474155174891,29.1460011950639,1.1723800740289652,4.476360282656048,684,2441,674,3799,0,674,0,0.1774151092392735,0.6425375098710187
42,35.255008406493424,29.556562657874405,1.1826962874492257,4.515749461169773,742,2549,663,3954,0,663,0,0.1676783004552352,0.644663631765301
43,35.808104597967784,30.05021378295187,1.1950339427391492,4.562856872276751,773,2625,703,4101,0,703,0,0.17142160448671057,0.640087783467447
44,36.170258208631786,30.37361002754939,1.203077924375585,4.593570256706778,796,2718,703,4217,0,703,0,0.16670618923405264,0.6445340289305194
45,36.31335788132715,30.501430987782996,1.2062489779053975,4.605677915638788,831,2781,696,4308,0,696,0,0.1615598885793872,0.6455431754874652
46,36.72527255396843,30.869477237606738,1.2153537449052596,4.640441571456447,849,2830,695,4374,0,695,0,0.15889346136259716,0.6470050297210791
47,37.02658655600841,31.138805470209494,1.2219923008261941,4.66578878497274,920,2888,615,4423,0,615,0,0.13904589645037305,0.6529504860954104
48,37.07535876299336,31.18240847133175,1.2230651548731655,4.669885136788451,902,2967,591,4460,0,591,0,0.13251121076233183,0.6652466367713005
49,37.15441056806746,31.25308664706304,1.2248030779443133,4.676520843060103,927,2987,571,4485,0,571,0,0.12731326644370122,0.6659977703455965
50,37.4079999240363,31.479854320236278,1.230369842298118,4.697775761501907,943,2997,565,4505,0,565,0,0.12541620421753608,0.6652608213096559
51,37.51669986285475,31.57707583392051,1.2327521569486148,4.706871871985621,959,3056,509,4524,0,509,0,0.11251105216622458,0.6755083996463307
