Iteration, Rt, delta p, delta n, nNT, nNe, nPT, nT, nI, nonmut, mut , GF , NF 
0,2.3251407699364424,0.19305994851394426,0.7371379852350601,0,0,25,25,51,5,20,1,0
1,2.695406417986039,0.21304704944955954,0.8134523706255911,12,0,19,31,51,5,14,0.6129032258064516,0
2,3.0806665237238335,0.23289266543199852,0.889226540740358,9,9,19,37,51,8,11,0.5135135135135135,0.24324324324324326
3,3.4372138555597536,0.2505322974454009,0.9565778629733492,13,9,23,45,51,11,12,0.5111111111111111,0.2
4,3.8942821161364054,0.27227700113829506,1.0396030952553081,15,13,29,57,51,14,15,0.5087719298245614,0.22807017543859648
5,4.317451662510421,0.2916605392844703,1.1136129681770683,12,21,40,73,51,23,17,0.547945205479452,0.2876712328767123
6,4.975058254951064,0.32057141839598213,1.2239999611482952,21,24,46,91,51,32,14,0.5054945054945055,0.26373626373626374
7,5.491136620217024,0.3423740587107096,1.3072464059863456,22,37,51,110,51,37,14,0.4636363636363636,0.33636363636363636
8,6.199904912816337,0.3712353900665152,1.4174442166176033,32,44,57,133,51,49,8,0.42857142857142855,0.3308270676691729
9,6.806467622407881,0.3950698375469174,1.5084484706336845,29,58,71,158,51,60,11,0.44936708860759494,0.3670886075949367
10,7.413903140577574,0.41823845064208104,1.5969104479061285,41,69,78,188,51,65,13,0.4148936170212766,0.3670212765957447
11,7.88495989376135,0.4357716881349354,1.6638555365152075,28,92,104,224,51,88,16,0.4642857142857143,0.4107142857142857
12,8.587457860987811,0.4612847507079697,1.761269048157702,59,94,108,261,51,93,15,0.41379310344827586,0.36015325670498083
13,9.130373513515108,0.4805276488981921,1.834741932156733,64,123,111,298,51,95,16,0.3724832214765101,0.412751677852349
14,9.887158205962344,0.5067265666953676,1.9347741637459486,77,137,129,343,51,113,16,0.3760932944606414,0.39941690962099125
15,10.631657498225616,0.5318551104990655,2.0307195128146134,90,170,119,379,51,108,11,0.31398416886543534,0.44854881266490765
16,11.152024803254875,0.5490709956147691,2.0964528923473,85,209,136,430,51,127,9,0.31627906976744186,0.48604651162790696
17,11.8639982204168,0.5721985247183426,2.184758003470036,107,220,156,483,51,144,12,0.32298136645962733,0.4554865424430642
18,12.551593164141243,0.5940986805120565,2.2683767801369434,118,255,166,539,51,156,10,0.3079777365491651,0.47309833024118736
19,13.234192151476206,0.6154474489116367,2.349890259480795,125,287,183,595,51,176,7,0.30756302521008405,0.4823529411764706
20,13.934201238890303,0.636962802038126,2.432039789600118,137,327,195,659,51,188,7,0.2959028831562974,0.496206373292868
21,14.647772912884568,0.6585272498303624,2.5143767720795656,153,367,203,723,51,200,3,0.28077455048409405,0.5076071922544951
22,15.332580973931774,0.6788953954564266,2.5921460553790845,158,412,216,786,51,213,3,0.2748091603053435,0.5241730279898219
23,15.996753691802375,0.698361984465095,2.6664730315939984,176,450,233,859,51,230,3,0.2712456344586729,0.5238649592549476
24,16.762648025720868,0.7204786278201928,2.750918397131645,204,492,241,937,51,235,6,0.25720384204909286,0.5250800426894343
25,17.545494694991824,0.742739344879077,2.8359138622655653,220,545,255,1020,51,253,2,0.25,0.5343137254901961
26,18.143944091480577,0.7595338804292012,2.9000384525478595,231,604,262,1097,51,260,2,0.23883318140382861,0.5505925250683683
27,18.868750342075636,0.7796292250703322,2.9767661320867234,246,659,276,1181,51,276,0,0.23370025402201525,0.5580016934801016
28,19.571792787452818,0.7988767058185671,3.0502565131254387,268,712,293,1273,51,293,0,0.23016496465043204,0.5593087195600943
29,20.306442218372855,0.8187448444161833,3.1261166786799746,279,772,310,1361,51,310,0,0.22777369581190302,0.5672299779573843
30,21.074903362592128,0.8392726675371485,3.204495639687292,307,840,316,1463,51,316,0,0.21599453178400546,0.5741626794258373
31,21.965349024076847,0.8627495818730765,3.294134767151747,327,912,327,1566,51,327,0,0.20881226053639848,0.5823754789272031
32,22.683902003212456,0.8814638921430545,3.3655894063643905,346,992,325,1663,51,325,0,0.19542994588093807,0.5965123271196633
33,23.355190085397403,0.8987694240045517,3.431665073471922,355,1063,352,1770,51,352,0,0.19887005649717515,0.6005649717514124
34,24.09896702118259,0.9177512190846084,3.5041410183230504,382,1123,370,1875,51,370,0,0.19733333333333333,0.5989333333333333
35,24.837841450246177,0.9364154822001858,3.5754045684007076,403,1200,388,1991,51,388,0,0.19487694625816174,0.6027122049221497
36,25.53073645706576,0.953750796292484,3.6415939494803915,402,1289,420,2111,51,420,0,0.1989578398863098,0.6106110847939366
37,26.25500741661678,0.9717042793725258,3.710143612149642,447,1348,448,2243,51,448,0,0.1997325011145787,0.6009808292465448
38,27.144673296902464,0.9935333076498332,3.793490811026637,463,1442,475,2380,51,475,0,0.19957983193277312,0.6058823529411764
39,27.87196648385265,1.0112016258536232,3.8609516623501965,502,1539,468,2509,51,468,0,0.18652849740932642,0.6133917895575927
40,28.617844905611058,1.02916253716869,3.9295296873713617,534,1616,494,2644,51,494,0,0.18683812405446293,0.6111951588502269
41,29.443270444507128,1.0488580535071574,4.004730749754601,566,1719,507,2792,51,507,0,0.18159025787965616,0.6156876790830945
42,30.18310902416489,1.0663554676878917,4.071539058444675,586,1836,516,2938,51,516,0,0.1756296800544588,0.6249149081007488
43,31.005241363790805,1.08563231687679,4.145141573529566,614,1927,549,3090,51,549,0,0.17766990291262136,0.6236245954692556
44,31.7592695309828,1.1031630032861257,4.212076921637935,635,2047,568,3250,51,568,0,0.17476923076923076,0.6298461538461538
45,32.49313650835288,1.1200922058761182,4.27671569516336,659,2168,579,3406,51,579,0,0.16999412800939517,0.6365237815619496
46,33.28657749854581,1.138252940462563,4.346056681766151,692,2269,604,3565,51,604,0,0.16942496493688639,0.6364656381486676
47,34.089097787052225,1.1564752869092199,4.415632913653383,740,2380,605,3725,51,605,0,0.16241610738255033,0.6389261744966444
48,34.795640141202675,1.1724002587616553,4.476437351635408,750,2512,627,3889,51,627,0,0.1612239650295706,0.6459244021599383
49,35.52327464066503,1.1886883714354999,4.538628327299179,805,2615,629,4049,51,629,0,0.1553469992590763,0.6458384786367004
50,36.094287457768104,1.2013927321243836,4.587135886293099,842,2725,623,4190,51,623,0,0.1486873508353222,0.6503579952267303
51,36.62358811875758,1.2131093384465779,4.631872019523298,866,2824,631,4321,51,631,0,0.1460310113399676,0.6535524184216617
52,37.07566751421949,1.2230719450496181,4.669911062916726,923,2905,600,4428,51,600,0,0.13550135501355012,0.6560523938572719
53,37.3971746046323,1.2301324636797926,4.696869406777386,938,2999,567,4504,51,567,0,0.12588809946714033,0.6658525754884547
54,37.588191652507795,1.234317747584242,4.712849581685288,966,3062,521,4549,51,521,0,0.11453066608045724,0.6731149703231479
55,37.69016152212165,1.2365490579231528,4.721369130252042,994,3085,488,4567,51,488,0,0.10685351434201883,0.6754981388219838
56,37.745687446308004,1.2377632329901533,4.726005071416952,1027,3085,465,4577,51,465,0,0.10159493117762727,0.6740222853397422
57,37.7652924776158,1.2381917903240545,4.727641381237301,1015,3109,457,4581,51,457,0,0.09975987775594848,0.6786727788692425
58,37.776189856031245,1.2384299701407244,4.728550795082763,1016,3109,457,4582,51,457,0,0.09973810563072893,0.678524661719773
59,37.77618985603127,1.2384299701407235,4.728550795082764,1017,3109,456,4582,51,456,0,0.09951986032300306,0.678524661719773
60,37.776189856031245,1.238429970140723,4.728550795082764,1017,3109,456,4582,51,456,0,0.09951986032300306,0.678524661719773
61,37.776189856031245,1.2384299701407244,4.728550795082761,1017,3109,456,4582,51,456,0,0.09951986032300306,0.678524661719773
62,37.778733799450116,1.2384855688379448,4.7287630810176084,1017,3109,456,4582,51,456,0,0.09951986032300306,0.678524661719773
63,37.77618985603128,1.238429970140724,4.728550795082765,1017,3109,456,4582,51,456,0,0.09951986032300306,0.678524661719773
64,37.776189856031266,1.2384299701407233,4.728550795082765,1017,3109,456,4582,51,456,0,0.09951986032300306,0.678524661719773
65,37.77618985603127,1.2384299701407244,4.728550795082763,1017,3109,456,4582,51,456,0,0.09951986032300306,0.678524661719773
66,37.77618985603126,1.238429970140724,4.728550795082765,1017,3109,456,4582,51,456,0,0.09951986032300306,0.678524661719773
67,37.77701948840533,1.2384481021587928,4.72862002642448,1017,3109,456,4582,51,456,0,0.09951986032300306,0.678524661719773
68,37.777019488405365,1.238448102158793,4.72862002642448,1017,3109,456,4582,51,456,0,0.09951986032300306,0.678524661719773
69,37.776189856031245,1.2384299701407242,4.7285507950827625,1017,3109,456,4582,51,456,0,0.09951986032300306,0.678524661719773
70,37.7761898560313,1.2384299701407235,4.728550795082764,1017,3109,456,4582,51,456,0,0.09951986032300306,0.678524661719773
71,37.77618985603125,1.2384299701407238,4.728550795082764,1017,3109,456,4582,51,456,0,0.09951986032300306,0.678524661719773
72,37.776189856031266,1.2384299701407235,4.728550795082763,1017,3109,456,4582,51,456,0,0.09951986032300306,0.678524661719773
73,37.77618985603126,1.2384299701407246,4.728550795082765,1017,3109,456,4582,51,456,0,0.09951986032300306,0.678524661719773
74,37.77618985603124,1.2384299701407244,4.7285507950827625,1017,3109,456,4582,51,456,0,0.09951986032300306,0.678524661719773
75,37.776189856031266,1.238429970140724,4.728550795082764,1017,3109,456,4582,51,456,0,0.09951986032300306,0.678524661719773
76,37.77618985603128,1.238429970140724,4.728550795082764,1017,3109,456,4582,51,456,0,0.09951986032300306,0.678524661719773
77,37.776189856031266,1.2384299701407235,4.728550795082764,1017,3109,456,4582,51,456,0,0.09951986032300306,0.678524661719773
78,37.776189856031294,1.2384299701407233,4.7285507950827625,1017,3109,456,4582,51,456,0,0.09951986032300306,0.678524661719773
79,37.77618985603128,1.2384299701407246,4.728550795082764,1017,3109,456,4582,51,456,0,0.09951986032300306,0.678524661719773
80,37.77618985603128,1.2384299701407246,4.728550795082765,1017,3109,456,4582,51,456,0,0.09951986032300306,0.678524661719773
81,37.776189856031245,1.2384299701407244,4.728550795082764,1017,3109,456,4582,51,456,0,0.09951986032300306,0.678524661719773
82,37.77618985603129,1.2384299701407238,4.728550795082763,1017,3109,456,4582,51,456,0,0.09951986032300306,0.678524661719773
83,37.77618985603128,1.238429970140723,4.728550795082764,1017,3109,456,4582,51,456,0,0.09951986032300306,0.678524661719773
84,37.77618985603128,1.2384299701407238,4.728550795082763,1017,3109,456,4582,51,456,0,0.09951986032300306,0.678524661719773
85,37.776189856031266,1.238429970140724,4.728550795082764,1017,3109,456,4582,51,456,0,0.09951986032300306,0.678524661719773
86,37.77618985603128,1.2384299701407235,4.728550795082764,1017,3109,456,4582,51,456,0,0.09951986032300306,0.678524661719773
87,37.77618985603125,1.2384299701407244,4.728550795082766,1017,3109,456,4582,51,456,0,0.09951986032300306,0.678524661719773
88,37.776189856031266,1.238429970140724,4.7285507950827625,1017,3109,456,4582,51,456,0,0.09951986032300306,0.678524661719773
89,37.77618985603125,1.2384299701407238,4.7285507950827625,1017,3109,456,4582,51,456,0,0.09951986032300306,0.678524661719773
90,37.77618985603129,1.2384299701407242,4.728550795082764,1017,3109,456,4582,51,456,0,0.09951986032300306,0.678524661719773
91,37.77618985603125,1.2384299701407244,4.72855079508276,1017,3109,456,4582,51,456,0,0.09951986032300306,0.678524661719773
92,37.77618985603127,1.2384299701407235,4.7285507950827625,1017,3109,456,4582,51,456,0,0.09951986032300306,0.678524661719773
93,37.77618985603127,1.238429970140724,4.728550795082764,1017,3109,456,4582,51,456,0,0.09951986032300306,0.678524661719773
94,37.77618985603128,1.2384299701407244,4.7285507950827625,1017,3109,456,4582,51,456,0,0.09951986032300306,0.678524661719773
95,37.77618985603128,1.2384299701407246,4.728550795082764,1017,3109,456,4582,51,456,0,0.09951986032300306,0.678524661719773
96,37.77618985603126,1.2384299701407246,4.728550795082762,1017,3109,456,4582,51,456,0,0.09951986032300306,0.678524661719773
97,37.776189856031245,1.238429970140724,4.7285507950827625,1017,3109,456,4582,51,456,0,0.09951986032300306,0.678524661719773
