Iteration, Rt, Rn, delta p, delta n, nNT, nNe, nPT, nT, nI, nonmut, mut , GF , NF 
0,2.325140769936443,1.3949428361874385,0.19305994851394429,0.7371379852350601,0,0,25,25,0,7,18,1,0
1,2.6671730732855905,1.6478543499165221,0.21155671617093866,0.8077620071981293,11,0,20,31,0,6,14,0.6451612903225806,0
2,3.128427266754891,1.994740063230765,0.2352935705427431,0.8983936329813828,6,9,26,41,0,9,17,0.6341463414634146,0.21951219512195122
3,3.686312767758063,2.421564800968099,0.2624948610318793,1.0022531057580848,14,9,28,51,0,12,16,0.5490196078431373,0.17647058823529413
4,4.339537581554196,2.9294757007787964,0.292654352613762,1.1174075281616367,14,20,25,59,0,11,14,0.423728813559322,0.3389830508474576
5,4.680509497932136,3.197520405163413,0.3077901890652072,1.1751989037035184,15,25,31,71,0,14,17,0.43661971830985913,0.352112676056338
6,5.075726802700516,3.5103891619936185,0.32488139712784675,1.2404562435790512,13,34,37,84,0,21,16,0.44047619047619047,0.40476190476190477
7,5.435843605008465,3.797315713948746,0.340071826446357,1.298456064613363,18,34,55,107,0,34,21,0.514018691588785,0.3177570093457944
8,6.194816637754068,4.407115813737093,0.3710322464940892,1.4166685775228862,27,40,68,135,0,43,25,0.5037037037037037,0.2962962962962963
9,6.824894711363935,4.9179423661082575,0.39578256222287683,1.5111697830328024,30,55,84,169,0,58,26,0.4970414201183432,0.3254437869822485
10,7.673671214151358,5.611721856618605,0.42795175345019404,1.6339976040825592,54,65,84,203,0,64,20,0.41379310344827586,0.32019704433497537
11,8.354521519720121,6.172343094791636,0.45290495611723336,1.7292734688112545,56,92,84,232,0,66,18,0.3620689655172414,0.39655172413793105
12,9.104494112685591,6.793601580068961,0.47961920488269794,1.8312733277339368,57,115,92,264,0,78,14,0.3484848484848485,0.4356060606060606
13,9.846488133426911,7.411687286404441,0.5053360248537201,1.9294648221687485,66,136,103,305,0,92,11,0.3377049180327869,0.4459016393442623
14,10.49937282918377,7.958099132372718,0.5274341634890856,2.013839533321963,69,164,112,345,0,102,10,0.32463768115942027,0.4753623188405797
15,11.249428516950527,8.588522657527717,0.5522634802575642,2.1086423791652456,85,179,126,390,0,120,6,0.3230769230769231,0.45897435897435895
16,11.930809601325608,9.16351234206554,0.5743447141860508,2.1929525450740126,92,212,135,439,0,129,6,0.30751708428246016,0.48291571753986334
17,12.564523724333183,9.700082666780382,0.5945066345864322,2.269934422966377,104,238,147,489,0,143,4,0.3006134969325153,0.4867075664621677
18,13.173378461207141,10.217131927184546,0.6135606014009157,2.342685932621678,111,265,175,551,0,171,4,0.3176043557168784,0.4809437386569873
19,13.824589069035989,10.771702345599373,0.6336179992038261,2.41926872423279,125,302,187,614,0,185,2,0.30456026058631924,0.49185667752442996
20,14.543695701956969,11.385839214575668,0.6554041766263056,2.5024523107549856,143,331,213,687,0,211,2,0.31004366812227074,0.48180494905385735
21,15.18538842531123,11.935315246308928,0.6745434899816091,2.5755296890206907,151,369,245,765,0,245,0,0.3202614379084967,0.4823529411764706
22,16.093214911482605,12.714866705375687,0.7011666088146433,2.6771815972922743,186,404,262,852,0,262,0,0.3075117370892019,0.47417840375586856
23,16.944022902351644,13.447630057686037,0.7256664394588981,2.7707264052067018,197,469,269,935,0,269,0,0.2877005347593583,0.5016042780748663
24,17.82981026064276,14.21260058399529,0.7507416310023067,2.86646804564517,215,530,280,1025,0,280,0,0.2731707317073171,0.5170731707317073
25,18.49132621380651,14.785191143996709,0.769197844677509,2.936937225132305,232,594,300,1126,0,300,0,0.2664298401420959,0.5275310834813499
26,19.233667502044536,15.428995064130852,0.7896489965481244,3.015023441365565,259,642,325,1226,0,325,0,0.26508972267536707,0.5236541598694943
27,20.162799245301983,16.236563069453034,0.8148792063082719,3.1113569695406738,282,706,348,1336,0,348,0,0.26047904191616766,0.5284431137724551
28,20.943860206164995,16.916872010522372,0.835790002869228,3.191198192773415,300,790,357,1447,0,357,0,0.24671734623358674,0.5459571527297857
29,21.787897779594623,17.653431803648754,0.8580967119887669,3.2763692639571103,335,850,369,1554,0,369,0,0.23745173745173745,0.546975546975547
30,22.502411598961345,18.278041961998685,0.8767559623884743,3.347613674574174,339,939,394,1672,0,394,0,0.23564593301435408,0.5616028708133971
31,23.430374039646168,19.090650964176024,0.9006972420787058,3.439025833391421,369,1017,400,1786,0,400,0,0.22396416573348266,0.5694288913773796
32,24.241788151047896,19.8024423996877,0.9213736465087212,3.517972104851479,392,1108,416,1916,0,416,0,0.21711899791231734,0.5782881002087683
33,25.222323835747925,20.66406200462012,0.9460543423095406,3.6122074888182443,420,1198,417,2035,0,417,0,0.2049140049140049,0.5886977886977887
34,25.918072528285915,21.276366091609884,0.9633730340270996,3.678333402648928,424,1325,415,2164,0,415,0,0.19177449168207025,0.6122920517560074
35,26.67408268150753,21.94254614221154,0.9820170175897331,3.7495195217062536,436,1401,460,2297,0,460,0,0.2002612102742708,0.6099259904222899
36,27.403217152966253,22.58584455736016,0.9998320481446606,3.817540547461432,490,1471,480,2441,0,480,0,0.19664072101597707,0.602621876280213
37,28.41908871306324,23.48338249961705,1.0243918556209064,3.9113143578252805,527,1572,489,2588,0,489,0,0.18894899536321483,0.60741885625966
38,29.233348096220602,24.203808384240283,1.0438667326751565,3.9856729793051398,531,1710,491,2732,0,491,0,0.17972181551976574,0.6259150805270863
39,30.043587354952724,24.921538358626588,1.0630667728224013,4.058982223503713,552,1821,516,2889,0,516,0,0.1786085150571132,0.6303219106957425
40,30.66771588215954,25.474972945231972,1.0777391001170424,4.115003836810523,576,1906,579,3061,0,579,0,0.18915387128389416,0.622672329304149
41,31.575952910701055,26.28118599208824,1.098913888768691,4.1958530298440895,634,1995,595,3224,0,595,0,0.18455334987593053,0.6187965260545906
42,32.48469175265496,27.08881895573274,1.1198981276631048,4.27597466925913,648,2145,604,3397,0,604,0,0.17780394465705035,0.6314395054459817
43,33.225208212338266,27.747641481625127,1.1368534724121593,4.340713258300972,678,2280,614,3572,0,614,0,0.17189249720044794,0.6382978723404256
44,34.04346213544814,28.476328028758594,1.1554429278034868,4.411691178886042,728,2385,632,3745,0,632,0,0.16875834445927904,0.636849132176235
45,34.81864616946428,29.167318917632755,1.1729169767952128,4.478410275036268,737,2528,657,3922,0,657,0,0.16751657317695054,0.644569097399286
46,35.575196238933316,29.842300117579892,1.1898463648092081,4.543049756544246,777,2662,644,4083,0,644,0,0.15772716140093068,0.6519715895175117
47,36.15685817493237,30.361641742505384,1.2027807689942744,4.592435663432687,827,2767,639,4233,0,639,0,0.15095676824946846,0.653673517599811
48,36.70618670446102,30.85242037255614,1.2149326349236609,4.63883369698125,878,2852,633,4363,0,633,0,0.1450836580334632,0.6536786614714646
49,37.072624328927965,31.179963790939983,1.223005017318256,4.669655520669704,930,2945,584,4459,0,584,0,0.13097106974657996,0.6604619869925993
50,37.383116695102274,31.45760025731077,1.2298241663340808,4.695692271457401,946,3024,558,4528,0,558,0,0.12323321554770318,0.6678445229681979
51,37.57034959953216,31.62506438742397,1.2339271194941532,4.711358092614035,971,3088,509,4568,0,509,0,0.11142732049036777,0.6760070052539404
52,37.66450558652793,31.70929143403132,1.2359878429709976,4.7192263095256255,987,3112,488,4587,0,488,0,0.10638761717898408,0.6784390669282756
53,37.71206875021318,31.751842111122613,1.237028170377287,4.723198468713274,1031,3112,450,4593,0,450,0,0.09797517962116264,0.6775527977356848
54,37.71635703548112,31.75567857519965,1.2371219445867188,4.723556515694743,1031,3112,451,4594,0,451,0,0.09817152808010449,0.6774053112755768
55,37.716357035481124,31.755678575199628,1.2371219445867188,4.723556515694742,1031,3112,451,4594,0,451,0,0.09817152808010449,0.6774053112755768
56,37.716357035481124,31.755678575199656,1.2371219445867188,4.723556515694745,1031,3112,451,4594,0,451,0,0.09817152808010449,0.6774053112755768
57,37.71635703548111,31.755678575199646,1.237121944586718,4.7235565156947406,1031,3112,451,4594,0,451,0,0.09817152808010449,0.6774053112755768
58,37.71635703548115,31.755678575199642,1.237121944586718,4.723556515694743,1031,3112,451,4594,0,451,0,0.09817152808010449,0.6774053112755768
59,37.71627306508117,31.755603451902648,1.2371201083955405,4.723549504782976,1034,3112,448,4594,0,448,0,0.09751850239442751,0.6774053112755768
60,37.7190152940173,31.758056763592585,1.2371800723523014,4.723778458072423,1038,3112,444,4594,0,441,3,0.09664780148019156,0.6774053112755768
61,37.727726283321076,31.765850022194968,1.2373705447620205,4.724505716364078,1051,3112,431,4594,0,424,7,0.09381802350892468,0.6774053112755768
62,37.71996983562367,31.758910737728556,1.2372009448461623,4.723858153048983,1063,3119,412,4594,0,398,14,0.08968219416630388,0.6789290378754897
63,37.72091325241896,31.759754759961655,1.237221573906227,4.723936918551047,1077,3119,398,4594,0,365,33,0.08663474096647801,0.6789290378754897
64,37.719888736184295,31.758838182635422,1.2371991714912818,4.723851382057618,1124,3119,351,4594,0,307,44,0.07640400522420548,0.6789290378754897
65,37.72670012327677,31.76493196773675,1.237348107753589,4.724420047786431,1159,3119,316,4594,0,230,86,0.06878537222464083,0.6789290378754897
66,37.725236341069184,31.76362239614668,1.2373161017763656,4.724297843146122,1185,3119,290,4594,0,188,102,0.0631258162821071,0.6789290378754897
67,37.71955977515307,31.758543879822106,1.2371919782762328,4.723823917054707,1225,3119,250,4594,0,122,128,0.0544188071397475,0.6789290378754897
